판매구분,국가번호,상품,할인수준,판매량,제조원가,판매가,총매출,할인액,실판매액,매출원가,수익,월
Government,1, Paseo , Low ,3450,10000,350000,1207500000,48300000,1159200000,897000000,262200000,7/1/2014
Government,2, Amarilla , None ,2750,260000,350000,962500000,0,962500000,715000000,247500000,2/1/2014
Government,3, Velo , Low ,2966,120000,350000,1038100000,20762000,1017338000,771160000,246178000,10/1/2013
Government,3, Amarilla , Low ,2966,260000,350000,1038100000,20762000,1017338000,771160000,246178000,10/1/2013
Government,3, Velo , Low ,2877,120000,350000,1006950000,20139000,986811000,748020000,238791000,10/1/2014
Government,3, VTT , Low ,2877,250000,350000,1006950000,20139000,986811000,748020000,238791000,10/1/2014
Government,4, Carretera , Low ,2852,3000,350000,998200000,19964000,978236000,741520000,236716000,12/1/2014
Government,4, Paseo , Low ,2852,10000,350000,998200000,19964000,978236000,741520000,236716000,12/1/2014
Government,2, Amarilla , Medium ,2876,260000,350000,1006600000,70462000,936138000,747760000,188378000,9/1/2014
Government,2, Carretera , Low ,2155,3000,350000,754250000,7542500,746707500,560300000,186407500,12/1/2014
Government,2, Paseo , Low ,2155,10000,350000,754250000,7542500,746707500,560300000,186407500,12/1/2014
Government,2, Velo , Low ,2177,120000,350000,761950000,30478000,731472000,566020000,165452000,10/1/2014
Government,2, VTT , Low ,2177,250000,350000,761950000,30478000,731472000,566020000,165452000,10/1/2014
Government,5, VTT , Low ,1940,250000,350000,679000000,13580000,665420000,504400000,161020000,12/1/2013
Government,4, Paseo , None ,1725,10000,350000,603750000,0,603750000,448500000,155250000,11/1/2013
Government,1, VTT , High ,2807,250000,350000,982450000,98245000,884205000,729820000,154385000,8/1/2014
Government,3, Amarilla , Low ,1907,260000,350000,667450000,26698000,640752000,495820000,144932000,9/1/2014
Government,2, Velo , Medium ,2076,120000,350000,726600000,43596000,683004000,539760000,143244000,10/1/2013
Government,2, Amarilla , Medium ,2076,260000,350000,726600000,43596000,683004000,539760000,143244000,10/1/2013
Government,3, Montana , Low ,1797,5000,350000,628950000,18868500,610081500,467220000,142861500,9/1/2013
Government,5, Amarilla , Low ,1865,260000,350000,652750000,26110000,626640000,484900000,141740000,2/1/2014
Government,5, Paseo , Medium ,2417,10000,350000,845950000,76135500,769814500,628420000,141394500,1/1/2014
Government,2, VTT , None ,1527,250000,350000,534450000,0,534450000,397020000,137430000,9/1/2013
Small Business,1, Paseo , Low ,2905,10000,300000,871500000,8715000,862785000,726250000,136535000,11/1/2014
Government,3, Carretera , None ,1513,3000,350000,529550000,0,529550000,393380000,136170000,12/1/2014
Government,3, Paseo , None ,1513,10000,350000,529550000,0,529550000,393380000,136170000,12/1/2014
Government,4, Amarilla , Low ,1778,260000,350000,622300000,24892000,597408000,462280000,135128000,12/1/2013
Government,3, Paseo , Medium ,2146,10000,350000,751100000,60088000,691012000,557960000,133052000,11/1/2013
Government,5, VTT , Low ,1642,250000,350000,574700000,17241000,557459000,426920000,130539000,8/1/2014
Government,1, Montana , High ,2313,5000,350000,809550000,80955000,728595000,601380000,127215000,5/1/2014
Government,4, Amarilla , High ,2240,260000,350000,784000000,78400000,705600000,582400000,123200000,2/1/2014
Government,1, Amarilla , Medium ,2071,260000,350000,724850000,65236500,659613500,538460000,121153500,9/1/2014
Government,5, Carretera , Low ,1397,3000,350000,488950000,4889500,484060500,363220000,120840500,10/1/2014
Government,5, VTT , Low ,1397,250000,350000,488950000,4889500,484060500,363220000,120840500,10/1/2014
Small Business,1, Montana , Low ,2498,5000,300000,749400000,7494000,741906000,624500000,117406000,9/1/2013
Government,4, Paseo , High ,2632,10000,350000,921200000,119756000,801444000,684320000,117124000,6/1/2014
Government,4, Velo , High ,2632,120000,350000,921200000,119756000,801444000,684320000,117124000,6/1/2014
Small Business,1, VTT , Low ,2844,250000,300000,853200000,25596000,827604000,711000000,116604000,2/1/2014
Government,5, Amarilla , Medium ,1679,260000,350000,587650000,35259000,552391000,436540000,115851000,9/1/2014
Government,1, Carretera , Medium ,1761,3000,350000,616350000,43144500,573205500,457860000,115345500,3/1/2014
Small Business,1, Paseo , Low ,2918,10000,300000,875400000,35016000,840384000,729500000,110884000,5/1/2014
Government,4, Paseo , High ,2104.5,10000,350000,736575000,81023250,655551750,547170000,108381750,7/1/2014
Small Business,1, Montana , Low ,2301,5000,300000,690300000,6903000,683397000,575250000,108147000,4/1/2014
Small Business,2, VTT , None ,2151,250000,300000,645300000,0,645300000,537750000,107550000,9/1/2014
Government,5, Paseo , High ,2851,10000,350000,997850000,149677500,848172500,741260000,106912500,5/1/2014
Government,5, Carretera , Low ,1210,3000,350000,423500000,4235000,419265000,314600000,104665000,3/1/2014
Government,2, Paseo , Medium ,1496,10000,350000,523600000,31416000,492184000,388960000,103224000,6/1/2014
Government,2, Velo , Medium ,1496,120000,350000,523600000,31416000,492184000,388960000,103224000,6/1/2014
Government,3, VTT , High ,1870,250000,350000,654500000,65450000,589050000,486200000,102850000,12/1/2013
Government,3, Montana , Medium ,1460,5000,350000,511000000,30660000,480340000,379600000,100740000,5/1/2014
Government,2, Montana , Medium ,1384.5,5000,350000,484575000,24228750,460346250,359970000,100376250,1/1/2014
Small Business,4, VTT , None ,2001,250000,300000,600300000,0,600300000,500250000,100050000,2/1/2014
Small Business,2, Paseo , Low ,2434.5,10000,300000,730350000,21910500,708439500,608625000,99814500,1/1/2014
Government,3, Amarilla , Medium ,1350,260000,350000,472500000,23625000,448875000,351000000,97875000,2/1/2014
Government,2, Montana , Medium ,1666,5000,350000,583100000,52479000,530621000,433160000,97461000,5/1/2014
Government,4, Montana , High ,2227.5,5000,350000,779625000,109147500,670477500,579150000,91327500,1/1/2014
Government,3, Paseo , None ,1006,10000,350000,352100000,0,352100000,261560000,90540000,6/1/2014
Government,3, Velo , None ,1006,120000,350000,352100000,0,352100000,261560000,90540000,6/1/2014
Government,4, Paseo , Medium ,1228,10000,350000,429800000,21490000,408310000,319280000,89030000,10/1/2013
Government,4, Amarilla , Medium ,1228,260000,350000,429800000,21490000,408310000,319280000,89030000,10/1/2013
Small Business,4, Montana , Medium ,3802.5,5000,300000,1140750000,102667500,1038082500,950625000,87457500,4/1/2014
Small Business,4, Velo , Medium ,3793.5,120000,300000,1138050000,102424500,1035625500,948375000,87250500,7/1/2014
Government,5, Carretera , Medium ,1362,3000,350000,476700000,38136000,438564000,354120000,84444000,12/1/2014
Government,5, Paseo , Medium ,1362,10000,350000,476700000,38136000,438564000,354120000,84444000,12/1/2014
Small Business,4, Paseo , Low ,1916,10000,300000,574800000,11496000,563304000,479000000,84304000,12/1/2014
Small Business,4, Amarilla , Low ,1916,260000,300000,574800000,11496000,563304000,479000000,84304000,12/1/2014
Government,4, VTT , Low ,943.5,250000,350000,330225000,3302250,326922750,245310000,81612750,4/1/2014
Government,5, Paseo , High ,2151,10000,350000,752850000,112927500,639922500,559260000,80662500,11/1/2013
Small Business,5, VTT , Medium ,2747,250000,300000,824100000,57687000,766413000,686750000,79663000,2/1/2014
Government,2, Carretera , High ,1790,3000,350000,626500000,81445000,545055000,465400000,79655000,3/1/2014
Government,1, VTT , Medium ,1351.5,250000,350000,473025000,42572250,430452750,351390000,79062750,4/1/2014
Government,2, Paseo , High ,1922,10000,350000,672700000,94178000,578522000,499720000,78802000,11/1/2013
Small Business,4, VTT , Medium ,2436,250000,300000,730800000,43848000,686952000,609000000,77952000,12/1/2013
Small Business,4, VTT , Low ,1874,250000,300000,562200000,16866000,545334000,468500000,76834000,8/1/2014
Small Business,3, Carretera , Low ,2021,3000,300000,606300000,24252000,582048000,505250000,76798000,10/1/2014
Small Business,3, Montana , Low ,2021,5000,300000,606300000,24252000,582048000,505250000,76798000,10/1/2014
Government,2, Paseo , High ,1594,10000,350000,557900000,66948000,490952000,414440000,76512000,11/1/2014
Government,3, Velo , Medium ,1307,120000,350000,457450000,41170500,416279500,339820000,76459500,7/1/2014
Small Business,3, Paseo , Low ,1728,10000,300000,518400000,10368000,508032000,432000000,76032000,5/1/2014
Government,1, Paseo , High ,2007,10000,350000,702450000,105367500,597082500,521820000,75262500,11/1/2013
Government,4, Velo , Medium ,1269,120000,350000,444150000,39973500,404176500,329940000,74236500,10/1/2014
Government,4, Amarilla , Medium ,1269,260000,350000,444150000,39973500,404176500,329940000,74236500,10/1/2014
Small Business,3, Montana , Low ,1859,5000,300000,557700000,22308000,535392000,464750000,70642000,8/1/2014
Government,5, Montana , Medium ,980,5000,350000,343000000,20580000,322420000,254800000,67620000,4/1/2014
Government,5, Velo , High ,1395,120000,350000,488250000,58590000,429660000,362700000,66960000,7/1/2014
Small Business,5, Paseo , Medium ,2460,10000,300000,738000000,59040000,678960000,615000000,63960000,6/1/2014
Small Business,5, Amarilla , Medium ,2460,260000,300000,738000000,59040000,678960000,615000000,63960000,6/1/2014
Small Business,2, Carretera , Medium ,2181,3000,300000,654300000,45801000,608499000,545250000,63249000,10/1/2014
Small Business,2, Montana , Medium ,2181,5000,300000,654300000,45801000,608499000,545250000,63249000,10/1/2014
Small Business,3, VTT , Medium ,2659,250000,300000,797700000,71793000,725907000,664750000,61157000,2/1/2014
Small Business,1, Amarilla , High ,2993,260000,300000,897900000,89790000,808110000,748250000,59860000,3/1/2014
Small Business,5, Paseo , Medium ,2565,10000,300000,769500000,69255000,700245000,641250000,58995000,1/1/2014
Government,5, Paseo , High ,1197,10000,350000,418950000,50274000,368676000,311220000,57456000,11/1/2014
Small Business,5, Paseo , Medium ,1607,10000,300000,482100000,24105000,457995000,401750000,56245000,4/1/2014
Small Business,4, VTT , Medium ,2134,250000,300000,640200000,51216000,588984000,533500000,55484000,9/1/2014
Small Business,3, Paseo , Low ,1414.5,10000,300000,424350000,16974000,407376000,353625000,53751000,4/1/2014
Government,2, VTT , High ,1281,250000,350000,448350000,62769000,385581000,333060000,52521000,12/1/2013
Government,5, Montana , Medium ,720,5000,350000,252000000,12600000,239400000,187200000,52200000,9/1/2013
Government,1, Paseo , Medium ,727,10000,350000,254450000,15267000,239183000,189020000,50163000,10/1/2013
Government,1, Amarilla , Medium ,727,260000,350000,254450000,15267000,239183000,189020000,50163000,10/1/2013
Small Business,4, Paseo , Medium ,1702,10000,300000,510600000,35742000,474858000,425500000,49358000,5/1/2014
Government,3, Montana , High ,1199,5000,350000,419650000,58751000,360899000,311740000,49159000,4/1/2014
Small Business,1, Paseo , High ,3495,10000,300000,1048500000,125820000,922680000,873750000,48930000,1/1/2014
Small Business,5, Amarilla , Low ,1101,260000,300000,330300000,6606000,323694000,275250000,48444000,3/1/2014
Government,1, Paseo , High ,1177,10000,350000,411950000,57673000,354277000,306020000,48257000,11/1/2014
Small Business,2, Velo , Medium ,1659,120000,300000,497700000,34839000,462861000,414750000,48111000,7/1/2014
Small Business,5, Montana , None ,958,5000,300000,287400000,0,287400000,239500000,47900000,8/1/2014
Small Business,3, Carretera , High ,2811,3000,300000,843300000,92763000,750537000,702750000,47787000,7/1/2014
Government,1, Velo , High ,986,120000,350000,345100000,41412000,303688000,256360000,47328000,10/1/2014
Government,1, VTT , High ,986,250000,350000,345100000,41412000,303688000,256360000,47328000,10/1/2014
Small Business,3, VTT , Low ,986,250000,300000,295800000,2958000,292842000,246500000,46342000,9/1/2014
Small Business,1, Velo , High ,2294,120000,300000,688200000,68820000,619380000,573500000,45880000,10/1/2013
Small Business,1, VTT , High ,2294,250000,300000,688200000,68820000,619380000,573500000,45880000,10/1/2013
Small Business,3, Velo , Medium ,1250,120000,300000,375000000,18750000,356250000,312500000,43750000,12/1/2014
Small Business,3, Amarilla , Medium ,1250,260000,300000,375000000,18750000,356250000,312500000,43750000,12/1/2014
Government,1, Montana , High ,982.5,5000,350000,343875000,44703750,299171250,255450000,43721250,1/1/2014
Government,1, Paseo , Medium ,602,10000,350000,210700000,10535000,200165000,156520000,43645000,6/1/2014
Government,1, Velo , Medium ,602,120000,350000,210700000,10535000,200165000,156520000,43645000,6/1/2014
Small Business,1, VTT , Medium ,1867,250000,300000,560100000,50409000,509691000,466750000,42941000,9/1/2014
Government,5, Carretera , High ,886,3000,350000,310100000,37212000,272888000,230360000,42528000,6/1/2014
Government,5, Paseo , High ,886,10000,350000,310100000,37212000,272888000,230360000,42528000,6/1/2014
Government,4, Carretera , High ,923,3000,350000,323050000,41996500,281053500,239980000,41073500,3/1/2014
Government,3, Carretera , High ,792,3000,350000,277200000,30492000,246708000,205920000,40788000,3/1/2014
Small Business,4, Paseo , Medium ,1404,10000,300000,421200000,29484000,391716000,351000000,40716000,11/1/2013
Small Business,2, Montana , Medium ,1562,5000,300000,468600000,37488000,431112000,390500000,40612000,8/1/2014
Small Business,2, Paseo , Low ,918,10000,300000,275400000,5508000,269892000,229500000,40392000,5/1/2014
Government,4, Amarilla , Medium ,552,260000,350000,193200000,9660000,183540000,143520000,40020000,8/1/2014
Small Business,1, Velo , Medium ,1372,120000,300000,411600000,28812000,382788000,343000000,39788000,12/1/2014
Small Business,1, Amarilla , Medium ,1372,260000,300000,411600000,28812000,382788000,343000000,39788000,12/1/2014
Government,3, Montana , High ,766,5000,350000,268100000,29491000,238609000,199160000,39449000,1/1/2014
Small Business,5, Paseo , None ,788,10000,300000,236400000,0,236400000,197000000,39400000,9/1/2013
Small Business,2, Velo , Medium ,1221,120000,300000,366300000,21978000,344322000,305250000,39072000,10/1/2013
Small Business,2, VTT , Medium ,1221,250000,300000,366300000,21978000,344322000,305250000,39072000,10/1/2013
Government,4, Amarilla , High ,707,260000,350000,247450000,24745000,222705000,183820000,38885000,9/1/2014
Small Business,5, Montana , Medium ,1100,5000,300000,330000000,16500000,313500000,275000000,38500000,12/1/2013
Government,2, Velo , Low ,3864,120000,20000,77280000,772800,76507200,38640000,37867200,4/1/2014
Government,4, Velo , Low ,3850.5,120000,20000,77010000,2310300,74699700,38505000,36194700,4/1/2014
Government,2, VTT , Medium ,574.5,250000,350000,201075000,16086000,184989000,149370000,35619000,4/1/2014
Government,2, Velo , High ,639,120000,350000,223650000,22365000,201285000,166140000,35145000,7/1/2014
Small Business,1, Carretera , Medium ,991,3000,300000,297300000,14865000,282435000,247750000,34685000,6/1/2014
Small Business,1, Paseo , Medium ,991,10000,300000,297300000,14865000,282435000,247750000,34685000,6/1/2014
Small Business,4, Montana , Medium ,1283,5000,300000,384900000,30792000,354108000,320750000,33358000,9/1/2013
Small Business,3, Paseo , Medium ,1123,10000,300000,336900000,23583000,313317000,280750000,32567000,9/1/2013
Channel Partners,4, Paseo , High ,4026,10000,12000,48312000,5314320,42997680,12078000,30919680,7/1/2014
Small Business,2, Paseo , Medium ,1324,10000,300000,397200000,35748000,361452000,331000000,30452000,11/1/2014
Small Business,5, Paseo , High ,2150,10000,300000,645000000,77400000,567600000,537500000,30100000,11/1/2014
Government,4, VTT , High ,623,250000,350000,218050000,26166000,191884000,161980000,29904000,9/1/2013
Government,4, Paseo , High ,700,10000,350000,245000000,34300000,210700000,182000000,28700000,11/1/2014
Small Business,5, Velo , High ,2605,120000,300000,781500000,101595000,679905000,651250000,28655000,11/1/2013
Small Business,3, Carretera , Low ,689,3000,300000,206700000,6201000,200499000,172250000,28249000,6/1/2014
Small Business,3, Paseo , Low ,689,10000,300000,206700000,6201000,200499000,172250000,28249000,6/1/2014
Small Business,2, VTT , Medium ,959,250000,300000,287700000,20139000,267561000,239750000,27811000,2/1/2014
Channel Partners,4, Amarilla , High ,3520.5,260000,12000,42246000,4224600,38021400,10561500,27459900,4/1/2014
Government,1, VTT , Low ,349,250000,350000,122150000,4886000,117264000,90740000,26524000,9/1/2013
Channel Partners,4, VTT , Medium ,3244.5,250000,12000,38934000,2725380,36208620,9733500,26475120,1/1/2014
Government,3, VTT , Medium ,422,250000,350000,147700000,11816000,135884000,109720000,26164000,8/1/2014
Channel Partners,3, VTT , None ,2838,250000,12000,34056000,0,34056000,8514000,25542000,4/1/2014
Government,1, Velo , Medium ,2832,120000,20000,56640000,2832000,53808000,28320000,25488000,8/1/2014
Small Business,4, Carretera , Medium ,1094,3000,300000,328200000,29538000,298662000,273500000,25162000,6/1/2014
Small Business,4, Paseo , Medium ,1094,10000,300000,328200000,29538000,298662000,273500000,25162000,6/1/2014
Government,5, Paseo , Medium ,2993,10000,20000,59860000,4788800,55071200,29930000,25141200,9/1/2014
Small Business,2, Montana , High ,1773,5000,300000,531900000,63828000,468072000,443250000,24822000,4/1/2014
Government,4, Velo , Low ,2646,120000,20000,52920000,2116800,50803200,26460000,24343200,9/1/2013
Government,3, Carretera , Low ,2580,3000,20000,51600000,1548000,50052000,25800000,24252000,4/1/2014
Government,1, Paseo , Medium ,2663,10000,20000,53260000,2663000,50597000,26630000,23967000,12/1/2014
Government,1, VTT , Medium ,2663,250000,20000,53260000,2663000,50597000,26630000,23967000,12/1/2014
Channel Partners,2, Carretera , Low ,2671,3000,12000,32052000,320520,31731480,8013000,23718480,9/1/2014
Government,2, VTT , Medium ,381,250000,350000,133350000,10668000,122682000,99060000,23622000,8/1/2014
Government,3, Montana , High ,2992,5000,20000,59840000,6582400,53257600,29920000,23337600,10/1/2013
Government,3, Paseo , High ,2992,10000,20000,59840000,6582400,53257600,29920000,23337600,10/1/2013
Small Business,4, Paseo , High ,1366,10000,300000,409800000,45078000,364722000,341500000,23222000,11/1/2014
Small Business,5, Carretera , Low ,494,3000,300000,148200000,1482000,146718000,123500000,23218000,10/1/2013
Small Business,5, VTT , Low ,494,250000,300000,148200000,1482000,146718000,123500000,23218000,10/1/2013
Government,4, VTT , High ,2935,250000,20000,58700000,6457000,52243000,29350000,22893000,11/1/2013
Channel Partners,4, Montana , None ,2518,5000,12000,30216000,0,30216000,7554000,22662000,6/1/2014
Channel Partners,4, Paseo , None ,2518,10000,12000,30216000,0,30216000,7554000,22662000,6/1/2014
Channel Partners,1, Montana , Medium ,2723,5000,12000,32676000,1960560,30715440,8169000,22546440,11/1/2014
Channel Partners,5, Paseo , Medium ,2763,10000,12000,33156000,2320920,30835080,8289000,22546080,11/1/2013
Government,1, VTT , Low ,266,250000,350000,93100000,1862000,91238000,69160000,22078000,12/1/2013
Government,2, VTT , Medium ,2682,250000,20000,53640000,4827600,48812400,26820000,21992400,11/1/2013
Government,2, Velo , High ,2805,120000,20000,56100000,6171000,49929000,28050000,21879000,9/1/2013
Channel Partners,3, VTT , Low ,2479,250000,12000,29748000,892440,28855560,7437000,21418560,1/1/2014
Channel Partners,1, Paseo , High ,2914,10000,12000,34968000,4895520,30072480,8742000,21330480,10/1/2014
Channel Partners,1, Amarilla , High ,2914,260000,12000,34968000,4895520,30072480,8742000,21330480,10/1/2014
Enterprise,3, Amarilla , None ,4219.5,260000,125000,527437500,0,527437500,506340000,21097500,4/1/2014
Small Business,1, VTT , Medium ,808,250000,300000,242400000,19392000,223008000,202000000,21008000,12/1/2013
Channel Partners,4, Amarilla , High ,2761,260000,12000,33132000,3975840,29156160,8283000,20873160,9/1/2013
Government,1, Carretera , Low ,274,3000,350000,95900000,3836000,92064000,71240000,20824000,12/1/2014
Government,1, Paseo , Low ,274,10000,350000,95900000,3836000,92064000,71240000,20824000,12/1/2014
Government,3, VTT , Medium ,2297,250000,20000,45940000,2297000,43643000,22970000,20673000,11/1/2013
Government,5, Amarilla , High ,2629,260000,20000,52580000,5783800,46796200,26290000,20506200,1/1/2014
Channel Partners,4, Paseo , Medium ,2431,10000,12000,29172000,1458600,27713400,7293000,20420400,12/1/2014
Channel Partners,4, Velo , Medium ,2431,120000,12000,29172000,1458600,27713400,7293000,20420400,12/1/2014
Small Business,1, VTT , High ,2541,250000,300000,762300000,106722000,655578000,635250000,20328000,8/1/2014
Small Business,3, Velo , High ,2536,120000,300000,760800000,106512000,654288000,634000000,20288000,11/1/2013
Channel Partners,5, Montana , High ,2661,5000,12000,31932000,3831840,28100160,7983000,20117160,5/1/2014
Channel Partners,3, Amarilla , High ,2574,260000,12000,30888000,3088800,27799200,7722000,20077200,8/1/2014
Government,3, Paseo , High ,2708,10000,20000,54160000,7040800,47119200,27080000,20039200,2/1/2014
Small Business,1, Velo , High ,2460,120000,300000,738000000,103320000,634680000,615000000,19680000,7/1/2014
Channel Partners,3, Montana , Medium ,2342,5000,12000,28104000,1405200,26698800,7026000,19672800,11/1/2014
Government,1, Paseo , High ,2641,10000,20000,52820000,6866600,45953400,26410000,19543400,2/1/2014
Channel Partners,3, Velo , None ,2161,120000,12000,25932000,0,25932000,6483000,19449000,3/1/2014
Channel Partners,1, Amarilla , None ,2141,260000,12000,25692000,0,25692000,6423000,19269000,8/1/2014
Government,2, Carretera , High ,2521.5,3000,20000,50430000,6051600,44378400,25215000,19163400,1/1/2014
Channel Partners,2, Montana , Medium ,2342,5000,12000,28104000,1967280,26136720,7026000,19110720,11/1/2014
Channel Partners,5, Montana , Medium ,2340,5000,12000,28080000,1965600,26114400,7020000,19094400,1/1/2014
Government,4, Paseo , Low ,2074,10000,20000,41480000,1659200,39820800,20740000,19080800,9/1/2014
Channel Partners,4, Carretera , Medium ,2299,3000,12000,27588000,1655280,25932720,6897000,19035720,10/1/2013
Channel Partners,4, Paseo , Medium ,2299,10000,12000,27588000,1655280,25932720,6897000,19035720,10/1/2013
Small Business,3, Paseo , High ,1359,10000,300000,407700000,48924000,358776000,339750000,19026000,11/1/2014
Government,2, Montana , None ,1899,5000,20000,37980000,0,37980000,18990000,18990000,6/1/2014
Government,2, Amarilla , None ,1899,260000,20000,37980000,0,37980000,18990000,18990000,6/1/2014
Government,4, Paseo , High ,2394,10000,20000,47880000,5266800,42613200,23940000,18673200,8/1/2014
Channel Partners,2, Paseo , High ,2425.5,10000,12000,29106000,3201660,25904340,7276500,18627840,7/1/2014
Government,5, Carretera , High ,2579,3000,20000,51580000,7221200,44358800,25790000,18568800,4/1/2014
Channel Partners,4, Montana , Medium ,2321,5000,12000,27852000,2506680,25345320,6963000,18382320,11/1/2014
Government,4, Paseo , None ,1817,10000,20000,36340000,0,36340000,18170000,18170000,12/1/2014
Government,4, VTT , None ,1817,250000,20000,36340000,0,36340000,18170000,18170000,12/1/2014
Channel Partners,2, Amarilla , High ,2475,260000,12000,29700000,4158000,25542000,7425000,18117000,8/1/2014
Channel Partners,3, VTT , Medium ,2215,250000,12000,26580000,1860600,24719400,6645000,18074400,9/1/2013
Government,5, Velo , High ,344,120000,350000,120400000,13244000,107156000,89440000,17716000,10/1/2013
Government,5, Amarilla , High ,344,260000,350000,120400000,13244000,107156000,89440000,17716000,10/1/2013
Channel Partners,2, VTT , Medium ,2234,250000,12000,26808000,2412720,24395280,6702000,17693280,9/1/2013
Channel Partners,1, Amarilla , Low ,1989,260000,12000,23868000,238680,23629320,5967000,17662320,9/1/2013
Channel Partners,1, Amarilla , None ,1953,260000,12000,23436000,0,23436000,5859000,17577000,4/1/2014
Government,4, Paseo , High ,2428,10000,20000,48560000,6798400,41761600,24280000,17481600,3/1/2014
Small Business,2, Velo , High ,853,120000,300000,255900000,25590000,230310000,213250000,17060000,12/1/2014
Small Business,2, Amarilla , High ,853,260000,300000,255900000,25590000,230310000,213250000,17060000,12/1/2014
Government,2, Montana , Medium ,1976,5000,20000,39520000,2766400,36753600,19760000,16993600,10/1/2014
Government,2, Velo , Medium ,1976,120000,20000,39520000,2766400,36753600,19760000,16993600,10/1/2014
Channel Partners,1, Carretera , Low ,1947,3000,12000,23364000,700920,22663080,5841000,16822080,9/1/2014
Government,5, Montana , High ,2255,5000,20000,45100000,5863000,39237000,22550000,16687000,7/1/2014
Small Business,2, Montana , High ,1186,5000,300000,355800000,42696000,313104000,296500000,16604000,12/1/2013
Channel Partners,5, VTT , Low ,1916,250000,12000,22992000,689760,22302240,5748000,16554240,4/1/2014
Small Business,5, Velo , Medium ,635,120000,300000,190500000,15240000,175260000,158750000,16510000,12/1/2014
Small Business,5, Amarilla , Medium ,635,260000,300000,190500000,15240000,175260000,158750000,16510000,12/1/2014
Channel Partners,1, Carretera , Low ,1858,3000,12000,22296000,222960,22073040,5574000,16499040,2/1/2014
Channel Partners,2, Montana , Low ,1901,5000,12000,22812000,684360,22127640,5703000,16424640,6/1/2014
Channel Partners,2, Paseo , Low ,1901,10000,12000,22812000,684360,22127640,5703000,16424640,6/1/2014
Government,5, Amarilla , High ,2039,260000,20000,40780000,4078000,36702000,20390000,16312000,5/1/2014
Channel Partners,4, Paseo , High ,2222,10000,12000,26664000,3732960,22931040,6666000,16265040,11/1/2013
Government,3, Paseo , Medium ,1934,10000,20000,38680000,3094400,35585600,19340000,16245600,9/1/2014
Government,4, Paseo , Medium ,1802,10000,20000,36040000,1802000,34238000,18020000,16218000,12/1/2013
Government,4, Carretera , None ,1618.5,3000,20000,32370000,0,32370000,16185000,16185000,1/1/2014
Channel Partners,4, VTT , High ,2109,250000,12000,25308000,3036960,22271040,6327000,15944040,5/1/2014
Government,3, Paseo , High ,357,10000,350000,124950000,16243500,108706500,92820000,15886500,11/1/2014
Government,5, Carretera , Medium ,1834,3000,20000,36680000,2567600,34112400,18340000,15772400,9/1/2013
Channel Partners,2, Carretera , Medium ,1865,3000,12000,22380000,1119000,21261000,5595000,15666000,2/1/2014
Channel Partners,2, Paseo , Low ,1785,10000,12000,21420000,428400,20991600,5355000,15636600,11/1/2013
Government,2, Paseo , High ,1954,10000,20000,39080000,3908000,35172000,19540000,15632000,3/1/2014
Midmarket,2, Paseo , Medium ,3801,10000,15000,57015000,3420900,53594100,38010000,15584100,4/1/2014
Channel Partners,2, Velo , Medium ,1967,120000,12000,23604000,2124360,21479640,5901000,15578640,3/1/2014
Channel Partners,1, VTT , Medium ,1956,250000,12000,23472000,2112480,21359520,5868000,15491520,1/1/2014
Government,2, Montana , Medium ,1757,5000,20000,35140000,2108400,33031600,17570000,15461600,10/1/2013
Government,2, Paseo , Medium ,1757,10000,20000,35140000,2108400,33031600,17570000,15461600,10/1/2013
Channel Partners,4, Carretera , Medium ,1884,3000,12000,22608000,1582560,21025440,5652000,15373440,8/1/2014
Government,1, Montana , Low ,1566,5000,20000,31320000,626400,30693600,15660000,15033600,10/1/2014
Government,1, Velo , Low ,1566,120000,20000,31320000,626400,30693600,15660000,15033600,10/1/2014
Channel Partners,4, Carretera , High ,1937,3000,12000,23244000,2556840,20687160,5811000,14876160,2/1/2014
Small Business,4, Paseo , High ,873,10000,300000,261900000,28809000,233091000,218250000,14841000,1/1/2014
Channel Partners,1, Amarilla , High ,2015,260000,12000,24180000,3385200,20794800,6045000,14749800,12/1/2013
Government,2, Velo , Medium ,1579,120000,20000,31580000,1579000,30001000,15790000,14211000,8/1/2014
Channel Partners,2, VTT , Medium ,1738.5,250000,12000,20862000,1460340,19401660,5215500,14186160,4/1/2014
Enterprise,1, Velo , None ,2821,120000,125000,352625000,0,352625000,338520000,14105000,8/1/2014
Government,2, Carretera , Medium ,1563,3000,20000,31260000,1563000,29697000,15630000,14067000,5/1/2014
Channel Partners,3, Paseo , Medium ,1775,10000,12000,21300000,1917000,19383000,5325000,14058000,11/1/2013
Channel Partners,3, Montana , None ,1545,5000,12000,18540000,0,18540000,4635000,13905000,6/1/2014
Channel Partners,3, Velo , None ,1545,120000,12000,18540000,0,18540000,4635000,13905000,6/1/2014
Government,5, Amarilla , Medium ,1694,260000,20000,33880000,3049200,30830800,16940000,13890800,11/1/2014
Government,2, Montana , Low ,1375.5,5000,20000,27510000,275100,27234900,13755000,13479900,7/1/2014
Midmarket,1, Paseo , Medium ,3675,10000,15000,55125000,4961250,50163750,36750000,13413750,4/1/2014
Enterprise,4, Montana , None ,2665.5,5000,125000,333187500,0,333187500,319860000,13327500,7/1/2014
Channel Partners,2, VTT , High ,1734,250000,12000,20808000,2288880,18519120,5202000,13317120,1/1/2014
Government,3, Carretera , None ,1321,3000,20000,26420000,0,26420000,13210000,13210000,1/1/2014
Government,2, Paseo , Medium ,1535,10000,20000,30700000,2149000,28551000,15350000,13201000,9/1/2014
Channel Partners,3, Amarilla , High ,1770,260000,12000,21240000,2761200,18478800,5310000,13168800,12/1/2013
Government,5, Montana , High ,1715,5000,20000,34300000,4116000,30184000,17150000,13034000,10/1/2013
Government,5, Paseo , High ,1715,10000,20000,34300000,4116000,30184000,17150000,13034000,10/1/2013
Channel Partners,1, VTT , High ,1806,250000,12000,21672000,3250800,18421200,5418000,13003200,5/1/2014
Small Business,2, Carretera , Medium ,448,3000,300000,134400000,9408000,124992000,112000000,12992000,6/1/2014
Small Business,2, Paseo , Medium ,448,10000,300000,134400000,9408000,124992000,112000000,12992000,6/1/2014
Government,1, Amarilla , High ,270,260000,350000,94500000,11340000,83160000,70200000,12960000,2/1/2014
Small Business,1, Velo , High ,2574,120000,300000,772200000,115830000,656370000,643500000,12870000,11/1/2013
Channel Partners,4, Carretera , Low ,1445,3000,12000,17340000,173400,17166600,4335000,12831600,9/1/2014
Government,3, Amarilla , Medium ,1520,260000,20000,30400000,2432000,27968000,15200000,12768000,11/1/2014
Government,1, Carretera , High ,1743,3000,20000,34860000,4880400,29979600,17430000,12549600,5/1/2014
Channel Partners,3, Carretera , Medium ,1580,3000,12000,18960000,1706400,17253600,4740000,12513600,9/1/2014
Government,4, Paseo , Medium ,1389,10000,20000,27780000,1389000,26391000,13890000,12501000,10/1/2013
Government,4, VTT , Medium ,1389,250000,20000,27780000,1389000,26391000,13890000,12501000,10/1/2013
Channel Partners,1, Velo , Low ,1465,120000,12000,17580000,703200,16876800,4395000,12481800,3/1/2014
Midmarket,2, VTT , High ,3874.5,250000,15000,58117500,6974100,51143400,38745000,12398400,7/1/2014
Small Business,2, Amarilla , High ,2475,260000,300000,742500000,111375000,631125000,618750000,12375000,3/1/2014
Midmarket,5, Paseo , None ,2472,10000,15000,37080000,0,37080000,24720000,12360000,9/1/2014
Midmarket,5, Carretera , None ,2470,3000,15000,37050000,0,37050000,24700000,12350000,6/1/2014
Midmarket,5, Montana , None ,2470,5000,15000,37050000,0,37050000,24700000,12350000,6/1/2014
Government,1, Velo , Medium ,1421,120000,20000,28420000,1989400,26430600,14210000,12220600,12/1/2013
Midmarket,2, Velo , High ,3997.5,120000,15000,59962500,7795130,52167380,39975000,12192380,1/1/2014
Midmarket,5, Velo , Medium ,2861,120000,15000,42915000,2145750,40769250,28610000,12159250,1/1/2014
Small Business,4, Carretera , High ,1496,3000,300000,448800000,62832000,385968000,374000000,11968000,10/1/2014
Small Business,4, VTT , High ,1496,250000,300000,448800000,62832000,385968000,374000000,11968000,10/1/2014
Government,1, Amarilla , Low ,1236,260000,20000,24720000,494400,24225600,12360000,11865600,11/1/2014
Midmarket,5, Carretera , Medium ,2791,3000,15000,41865000,2093250,39771750,27910000,11861750,11/1/2014
Channel Partners,1, Paseo , Low ,1369.5,10000,12000,16434000,493020,15940980,4108500,11832480,7/1/2014
Small Business,5, Paseo , High ,591,10000,300000,177300000,17730000,159570000,147750000,11820000,5/1/2014
Government,2, Paseo , Medium ,1303,10000,20000,26060000,1303000,24757000,13030000,11727000,2/1/2014
Midmarket,4, Carretera , Medium ,2844,3000,15000,42660000,2559600,40100400,28440000,11660400,6/1/2014
Midmarket,4, VTT , Medium ,2844,250000,15000,42660000,2559600,40100400,28440000,11660400,6/1/2014
Government,3, Paseo , High ,1531,10000,20000,30620000,3674400,26945600,15310000,11635600,12/1/2014
Government,3, VTT , High ,1531,250000,20000,30620000,3674400,26945600,15310000,11635600,12/1/2014
Midmarket,1, Paseo , Medium ,2931,10000,15000,43965000,3077550,40887450,29310000,11577450,9/1/2013
Government,3, Paseo , Medium ,1366,10000,20000,27320000,2185600,25134400,13660000,11474400,6/1/2014
Government,3, Amarilla , Medium ,1366,260000,20000,27320000,2185600,25134400,13660000,11474400,6/1/2014
Small Business,3, Amarilla , Low ,259,260000,300000,77700000,1554000,76146000,64750000,11396000,3/1/2014
Government,1, VTT , Medium ,1265,250000,20000,25300000,1265000,24035000,12650000,11385000,11/1/2013
Channel Partners,4, Carretera , Low ,1295,3000,12000,15540000,310800,15229200,3885000,11344200,10/1/2014
Channel Partners,4, Paseo , Low ,1295,10000,12000,15540000,310800,15229200,3885000,11344200,10/1/2014
Midmarket,2, Paseo , Low ,2296,10000,15000,34440000,344400,34095600,22960000,11135600,2/1/2014
Midmarket,2, Paseo , Medium ,2620,10000,15000,39300000,1965000,37335000,26200000,11135000,9/1/2014
Midmarket,4, Paseo , Low ,2363,10000,15000,35445000,708900,34736100,23630000,11106100,2/1/2014
Channel Partners,5, Amarilla , Medium ,1375,260000,12000,16500000,1320000,15180000,4125000,11055000,12/1/2013
Midmarket,2, Carretera , None ,2178,3000,15000,32670000,0,32670000,21780000,10890000,6/1/2014
Midmarket,2, VTT , None ,2178,250000,15000,32670000,0,32670000,21780000,10890000,6/1/2014
Government,1, Montana , Medium ,1282,5000,20000,25640000,2051200,23588800,12820000,10768800,6/1/2014
Government,1, Amarilla , Medium ,1282,260000,20000,25640000,2051200,23588800,12820000,10768800,6/1/2014
Midmarket,4, Paseo , None ,2152,10000,15000,32280000,0,32280000,21520000,10760000,12/1/2013
Midmarket,5, Montana , Low ,2214,5000,15000,33210000,332100,32877900,22140000,10737900,3/1/2014
Midmarket,1, Amarilla , High ,3199.5,260000,15000,47992500,5279180,42713330,31995000,10718330,7/1/2014
Channel Partners,2, Paseo , High ,1393,10000,12000,16716000,2340240,14375760,4179000,10196760,10/1/2014
Channel Partners,2, Amarilla , High ,1393,260000,12000,16716000,2340240,14375760,4179000,10196760,10/1/2014
Small Business,2, Velo , Medium ,386,120000,300000,115800000,9264000,106536000,96500000,10036000,11/1/2013
Channel Partners,1, Montana , Low ,1142,5000,12000,13704000,274080,13429920,3426000,10003920,6/1/2014
Channel Partners,1, Paseo , Low ,1142,10000,12000,13704000,274080,13429920,3426000,10003920,6/1/2014
Midmarket,2, Paseo , Low ,2261,10000,15000,33915000,1356600,32558400,22610000,9948400,12/1/2013
Government,5, VTT , Medium ,1123,250000,20000,22460000,1347600,21112400,11230000,9882400,11/1/2013
Government,1, Carretera , Medium ,1117.5,3000,20000,22350000,1341000,21009000,11175000,9834000,1/1/2014
Government,1, Paseo , Low ,1056,10000,20000,21120000,844800,20275200,10560000,9715200,9/1/2014
Government,4, Amarilla , Medium ,1118,260000,20000,22360000,1565200,20794800,11180000,9614800,11/1/2014
Midmarket,5, Velo , Medium ,2628,120000,15000,39420000,3547800,35872200,26280000,9592200,4/1/2014
Midmarket,2, Montana , Medium ,2501,5000,15000,37515000,3001200,34513800,25010000,9503800,3/1/2014
Channel Partners,5, Paseo , Low ,1084,10000,12000,13008000,260160,12747840,3252000,9495840,12/1/2014
Channel Partners,5, Velo , Low ,1084,120000,12000,13008000,260160,12747840,3252000,9495840,12/1/2014
Channel Partners,5, Amarilla , Medium ,1123,260000,12000,13476000,673800,12802200,3369000,9433200,8/1/2014
Small Business,3, Carretera , Low ,214,3000,300000,64200000,1284000,62916000,53500000,9416000,10/1/2013
Small Business,3, VTT , Low ,214,250000,300000,64200000,1284000,62916000,53500000,9416000,10/1/2013
Channel Partners,3, Carretera , Medium ,1116,3000,12000,13392000,669600,12722400,3348000,9374400,2/1/2014
Government,5, Paseo , High ,1233,10000,20000,24660000,2959200,21700800,12330000,9370800,12/1/2014
Government,5, VTT , High ,1233,250000,20000,24660000,2959200,21700800,12330000,9370800,12/1/2014
Government,2, Velo , Medium ,1033,120000,20000,20660000,1033000,19627000,10330000,9297000,12/1/2013
Government,4, Montana , High ,1249,5000,20000,24980000,3247400,21732600,12490000,9242600,10/1/2014
Government,4, Paseo , High ,1249,10000,20000,24980000,3247400,21732600,12490000,9242600,10/1/2014
Channel Partners,2, Paseo , Low ,1055,10000,12000,12660000,253200,12406800,3165000,9241800,12/1/2014
Channel Partners,2, Velo , Low ,1055,120000,12000,12660000,253200,12406800,3165000,9241800,12/1/2014
Channel Partners,2, Carretera , High ,1198,3000,12000,14376000,1581360,12794640,3594000,9200640,10/1/2013
Channel Partners,2, Paseo , High ,1198,10000,12000,14376000,1581360,12794640,3594000,9200640,10/1/2013
Midmarket,1, Paseo , Low ,1925,10000,15000,28875000,577500,28297500,19250000,9047500,12/1/2013
Government,2, Amarilla , Low ,941,260000,20000,18820000,376400,18443600,9410000,9033600,11/1/2014
Enterprise,2, Velo , None ,1804,120000,125000,225500000,0,225500000,216480000,9020000,2/1/2014
Midmarket,1, Paseo , Medium ,2198,10000,15000,32970000,1978200,30991800,21980000,9011800,8/1/2014
Midmarket,3, Paseo , Medium ,2116,10000,15000,31740000,1587000,30153000,21160000,8993000,12/1/2013
Midmarket,5, Montana , Low ,2031,5000,15000,30465000,1218600,29246400,20310000,8936400,10/1/2014
Midmarket,5, Paseo , Low ,2031,10000,15000,30465000,1218600,29246400,20310000,8936400,10/1/2014
Small Business,3, Paseo , High ,807,10000,300000,242100000,31473000,210627000,201750000,8877000,1/1/2014
Midmarket,3, Paseo , Low ,1945,10000,15000,29175000,875250,28299750,19450000,8849750,10/1/2013
Midmarket,3, VTT , Low ,1945,250000,15000,29175000,875250,28299750,19450000,8849750,10/1/2013
Government,3, Velo , Medium ,1001,120000,20000,20020000,1201200,18818800,10010000,8808800,8/1/2014
Government,5, Paseo , High ,1122,10000,20000,22440000,2468400,19971600,11220000,8751600,3/1/2014
Government,1, Paseo , Low ,4492.5,10000,7000,31447500,314480,31133030,22462500,8670530,4/1/2014
Midmarket,4, Montana , Low ,1967,5000,15000,29505000,1180200,28324800,19670000,8654800,3/1/2014
Small Business,5, VTT , High ,432,250000,300000,129600000,12960000,116640000,108000000,8640000,9/1/2014
Midmarket,4, Carretera , High ,2689,3000,15000,40335000,4840200,35494800,26890000,8604800,11/1/2014
Government,5, Paseo , Medium ,1038,10000,20000,20760000,1868400,18891600,10380000,8511600,6/1/2014
Government,5, Amarilla , Medium ,1038,260000,20000,20760000,1868400,18891600,10380000,8511600,6/1/2014
Midmarket,1, Carretera , Medium ,2030,3000,15000,30450000,1827000,28623000,20300000,8323000,11/1/2014
Midmarket,2, Paseo , Medium ,2101,10000,15000,31515000,2206050,29308950,21010000,8298950,8/1/2014
Channel Partners,1, Paseo , None ,912,10000,12000,10944000,0,10944000,2736000,8208000,11/1/2013
Government,4, Montana , High ,200,5000,350000,70000000,9800000,60200000,52000000,8200000,5/1/2014
Midmarket,1, Amarilla , High ,2548,260000,15000,38220000,4586400,33633600,25480000,8153600,11/1/2013
Government,3, Paseo , High ,1158,10000,20000,23160000,3474000,19686000,11580000,8106000,3/1/2014
Small Business,1, Carretera , High ,1010,3000,300000,303000000,42420000,260580000,252500000,8080000,10/1/2014
Small Business,1, VTT , High ,1010,250000,300000,303000000,42420000,260580000,252500000,8080000,10/1/2014
Government,1, Paseo , Medium ,973,10000,20000,19460000,1751400,17708600,9730000,7978600,3/1/2014
Channel Partners,4, Carretera , Low ,908,3000,12000,10896000,326880,10569120,2724000,7845120,12/1/2013
Midmarket,1, Carretera , High ,2567,3000,15000,38505000,5005650,33499350,25670000,7829350,6/1/2014
Midmarket,1, VTT , High ,2567,250000,15000,38505000,5005650,33499350,25670000,7829350,6/1/2014
Government,4, Carretera , Low ,831,3000,20000,16620000,498600,16121400,8310000,7811400,5/1/2014
Midmarket,2, Velo , High ,2826,120000,15000,42390000,6358500,36031500,28260000,7771500,5/1/2014
Channel Partners,5, VTT , High ,1005,250000,12000,12060000,1326600,10733400,3015000,7718400,9/1/2013
Small Business,3, Montana , Medium ,334,5000,300000,100200000,9018000,91182000,83500000,7682000,12/1/2013
Government,2, Paseo , Low ,3945,10000,7000,27615000,276150,27338850,19725000,7613850,1/1/2014
Midmarket,2, Paseo , High ,2167,10000,15000,32505000,3250500,29254500,21670000,7584500,10/1/2013
Midmarket,2, VTT , High ,2167,250000,15000,32505000,3250500,29254500,21670000,7584500,10/1/2013
Channel Partners,3, Paseo , High ,1013,10000,12000,12156000,1580280,10575720,3039000,7536720,12/1/2014
Channel Partners,3, Velo , High ,1013,120000,12000,12156000,1580280,10575720,3039000,7536720,12/1/2014
Small Business,2, Montana , Medium ,322,5000,300000,96600000,8694000,87906000,80500000,7406000,9/1/2013
Channel Partners,2, VTT , Low ,866,250000,12000,10392000,415680,9976320,2598000,7378320,5/1/2014
Midmarket,1, Paseo , Low ,1514,10000,15000,22710000,227100,22482900,15140000,7342900,2/1/2014
Government,4, Paseo , Low ,4251,10000,7000,29757000,1190280,28566720,21255000,7311720,1/1/2014
Midmarket,2, Montana , High ,2072,5000,15000,31080000,3108000,27972000,20720000,7252000,12/1/2014
Midmarket,2, Amarilla , High ,2072,260000,15000,31080000,3108000,27972000,20720000,7252000,12/1/2014
Midmarket,5, Montana , High ,2157,5000,15000,32355000,3559050,28795950,21570000,7225950,12/1/2014
Midmarket,5, Amarilla , High ,2157,260000,15000,32355000,3559050,28795950,21570000,7225950,12/1/2014
Midmarket,4, Paseo , High ,2470,10000,15000,37050000,5187000,31863000,24700000,7163000,9/1/2013
Midmarket,3, Paseo , Medium ,1743,10000,15000,26145000,1568700,24576300,17430000,7146300,8/1/2014
Small Business,4, Amarilla , High ,888,260000,300000,266400000,37296000,229104000,222000000,7104000,3/1/2014
Midmarket,4, Paseo , High ,2559,10000,15000,38385000,5757750,32627250,25590000,7037250,8/1/2014
Channel Partners,3, VTT , Medium ,880,250000,12000,10560000,950400,9609600,2640000,6969600,5/1/2014
Government,5, Paseo , High ,905,10000,20000,18100000,2172000,15928000,9050000,6878000,10/1/2014
Government,5, Velo , High ,905,120000,20000,18100000,2172000,15928000,9050000,6878000,10/1/2014
Enterprise,5, Paseo , Low ,1823,10000,125000,227875000,2278750,225596250,218760000,6836250,7/1/2014
Enterprise,4, Paseo , Low ,2729,10000,125000,341125000,6822500,334302500,327480000,6822500,12/1/2014
Enterprise,4, VTT , Low ,2729,250000,125000,341125000,6822500,334302500,327480000,6822500,12/1/2014
Channel Partners,3, Carretera , Low ,766,3000,12000,9192000,91920,9100080,2298000,6802080,10/1/2013
Channel Partners,3, Paseo , Low ,766,10000,12000,9192000,91920,9100080,2298000,6802080,10/1/2013
Government,1, Velo , Low ,736,120000,20000,14720000,588800,14131200,7360000,6771200,9/1/2013
Midmarket,4, Carretera , High ,2300,3000,15000,34500000,4830000,29670000,23000000,6670000,12/1/2014
Midmarket,4, Montana , High ,2300,5000,15000,34500000,4830000,29670000,23000000,6670000,12/1/2014
Midmarket,5, Paseo , Low ,1514,10000,15000,22710000,908400,21801600,15140000,6661600,10/1/2013
Midmarket,5, VTT , Low ,1514,250000,15000,22710000,908400,21801600,15140000,6661600,10/1/2013
Midmarket,5, Paseo , High ,1984,10000,15000,29760000,3273600,26486400,19840000,6646400,8/1/2014
Channel Partners,1, Paseo , High ,914,10000,12000,10968000,1645200,9322800,2742000,6580800,12/1/2014
Channel Partners,1, Velo , High ,914,120000,12000,10968000,1645200,9322800,2742000,6580800,12/1/2014
Enterprise,2, VTT , Low ,1744,250000,125000,218000000,2180000,215820000,209280000,6540000,11/1/2014
Small Business,5, Carretera , High ,801,3000,300000,240300000,33642000,206658000,200250000,6408000,7/1/2014
Midmarket,3, Velo , Medium ,1530,120000,15000,22950000,1377000,21573000,15300000,6273000,5/1/2014
Government,4, VTT , High ,865.5,250000,20000,17310000,2596500,14713500,8655000,6058500,7/1/2014
Channel Partners,5, Montana , Low ,690,5000,12000,8280000,165600,8114400,2070000,6044400,11/1/2014
Midmarket,4, Amarilla , Medium ,1630.5,260000,15000,24457500,2201180,22256330,16305000,5951330,7/1/2014
Government,4, Montana , Medium ,708,5000,20000,14160000,1132800,13027200,7080000,5947200,6/1/2014
Government,4, Amarilla , Medium ,708,260000,20000,14160000,1132800,13027200,7080000,5947200,6/1/2014
Channel Partners,5, Carretera , Medium ,727,3000,12000,8724000,610680,8113320,2181000,5932320,2/1/2014
Enterprise,3, Amarilla , Low ,2276,260000,125000,284500000,5690000,278810000,273120000,5690000,5/1/2014
Government,3, Carretera , Medium ,663,3000,20000,13260000,1193400,12066600,6630000,5436600,5/1/2014
Midmarket,5, Amarilla , High ,1870,260000,15000,28050000,3927000,24123000,18700000,5423000,11/1/2013
Government,3, Montana , Medium ,645,5000,20000,12900000,1032000,11868000,6450000,5418000,7/1/2014
Enterprise,5, Paseo , Low ,2145,10000,125000,268125000,5362500,262762500,257400000,5362500,10/1/2013
Enterprise,5, Velo , Low ,2145,120000,125000,268125000,5362500,262762500,257400000,5362500,10/1/2013
Enterprise,2, Carretera , Low ,4243.5,3000,125000,530437500,15913130,514524380,509220000,5304380,4/1/2014
Government,5, Velo , Medium ,609,120000,20000,12180000,852600,11327400,6090000,5237400,8/1/2014
Midmarket,4, Carretera , High ,1560,3000,15000,23400000,2574000,20826000,15600000,5226000,11/1/2013
Government,5, Velo , Low ,544,120000,20000,10880000,217600,10662400,5440000,5222400,12/1/2013
Midmarket,1, Paseo , High ,1767,10000,15000,26505000,3710700,22794300,17670000,5124300,9/1/2014
Government,3, Velo , Medium ,588,120000,20000,11760000,823200,10936800,5880000,5056800,12/1/2013
Midmarket,4, Paseo , High ,1743,10000,15000,26145000,3660300,22484700,17430000,5054700,10/1/2013
Midmarket,4, Amarilla , High ,1743,260000,15000,26145000,3660300,22484700,17430000,5054700,10/1/2013
Midmarket,4, Velo , Medium ,1262,120000,15000,18930000,1325100,17604900,12620000,4984900,5/1/2014
Government,4, Carretera , Low ,2851,3000,7000,19957000,798280,19158720,14255000,4903720,10/1/2013
Government,4, Montana , Low ,2851,5000,7000,19957000,798280,19158720,14255000,4903720,10/1/2013
Government,1, Carretera , Low ,2529,3000,7000,17703000,177030,17525970,12645000,4880970,7/1/2014
Midmarket,5, Paseo , None ,974,10000,15000,14610000,0,14610000,9740000,4870000,2/1/2014
Channel Partners,4, Velo , Medium ,598,120000,12000,7176000,574080,6601920,1794000,4807920,3/1/2014
Midmarket,4, Paseo , High ,1565,10000,15000,23475000,3051750,20423250,15650000,4773250,10/1/2014
Midmarket,4, VTT , High ,1565,250000,15000,23475000,3051750,20423250,15650000,4773250,10/1/2014
Midmarket,1, Paseo , Medium ,1153,10000,15000,17295000,1037700,16257300,11530000,4727300,10/1/2014
Midmarket,1, VTT , Medium ,1153,250000,15000,17295000,1037700,16257300,11530000,4727300,10/1/2014
Channel Partners,5, Carretera , Medium ,562,3000,12000,6744000,404640,6339360,1686000,4653360,9/1/2014
Midmarket,3, Montana , None ,921,5000,15000,13815000,0,13815000,9210000,4605000,3/1/2014
Channel Partners,5, Montana , High ,604,5000,12000,7248000,942240,6305760,1812000,4493760,6/1/2014
Channel Partners,5, Velo , High ,604,120000,12000,7248000,942240,6305760,1812000,4493760,6/1/2014
Midmarket,2, Paseo , Medium ,1227,10000,15000,18405000,1656450,16748550,12270000,4478550,10/1/2014
Midmarket,2, VTT , Medium ,1227,250000,15000,18405000,1656450,16748550,12270000,4478550,10/1/2014
Midmarket,3, Carretera , None ,888,3000,15000,13320000,0,13320000,8880000,4440000,6/1/2014
Midmarket,3, VTT , None ,888,250000,15000,13320000,0,13320000,8880000,4440000,6/1/2014
Midmarket,4, Paseo , High ,1614,10000,15000,24210000,3631500,20578500,16140000,4438500,4/1/2014
Government,5, Paseo , Medium ,2689,10000,7000,18823000,941150,17881850,13445000,4436850,10/1/2014
Government,5, VTT , Medium ,2689,250000,7000,18823000,941150,17881850,13445000,4436850,10/1/2014
Midmarket,3, Carretera , High ,1513,3000,15000,22695000,3177300,19517700,15130000,4387700,11/1/2014
Government,1, Velo , High ,606,120000,20000,12120000,1696800,10423200,6060000,4363200,4/1/2014
Government,3, Montana , None ,2146,5000,7000,15022000,0,15022000,10730000,4292000,9/1/2014
Channel Partners,5, Paseo , High ,571,10000,12000,6852000,890760,5961240,1713000,4248240,7/1/2014
Government,1, Velo , Medium ,2907,120000,7000,20349000,1627920,18721080,14535000,4186080,6/1/2014
Government,1, Amarilla , Medium ,2907,260000,7000,20349000,1627920,18721080,14535000,4186080,6/1/2014
Enterprise,5, Montana , Low ,1660,5000,125000,207500000,4150000,203350000,199200000,4150000,11/1/2013
Government,2, Carretera , Medium ,2487,3000,7000,17409000,870450,16538550,12435000,4103550,12/1/2014
Government,2, VTT , Medium ,2487,250000,7000,17409000,870450,16538550,12435000,4103550,12/1/2014
Government,4, Velo , Low ,2092,120000,7000,14644000,146440,14497560,10460000,4037560,11/1/2013
Government,2, Carretera , Low ,2145,3000,7000,15015000,300300,14714700,10725000,3989700,11/1/2013
Government,2, Amarilla , High ,3421.5,260000,7000,23950500,2874060,21076440,17107500,3968940,7/1/2014
Government,4, Paseo , Medium ,2349,10000,7000,16443000,822150,15620850,11745000,3875850,9/1/2013
Government,1, Paseo , Medium ,2327,10000,7000,16289000,814450,15474550,11635000,3839550,5/1/2014
Government,1, Paseo , Low ,2013,10000,7000,14091000,281820,13809180,10065000,3744180,12/1/2013
Government,1, VTT , Medium ,436.5,250000,20000,8730000,698400,8031600,4365000,3666600,7/1/2014
Channel Partners,3, Velo , High ,472,120000,12000,5664000,623040,5040960,1416000,3624960,10/1/2014
Channel Partners,3, Amarilla , High ,472,260000,12000,5664000,623040,5040960,1416000,3624960,10/1/2014
Midmarket,3, Paseo , Low ,747,10000,15000,11205000,112050,11092950,7470000,3622950,9/1/2014
Channel Partners,5, Velo , High ,500,120000,12000,6000000,900000,5100000,1500000,3600000,3/1/2014
Midmarket,3, Amarilla , Medium ,970,260000,15000,14550000,1309500,13240500,9700000,3540500,11/1/2013
Government,4, Montana , Low ,1830,5000,7000,12810000,128100,12681900,9150000,3531900,8/1/2014
Government,2, Paseo , Medium ,2136,10000,7000,14952000,747600,14204400,10680000,3524400,12/1/2013
Government,3, Montana , Low ,1958,5000,7000,13706000,411180,13294820,9790000,3504820,2/1/2014
Government,3, Paseo , Medium ,2409,10000,7000,16863000,1349040,15513960,12045000,3468960,9/1/2013
Government,3, Velo , High ,2665,120000,7000,18655000,1865500,16789500,13325000,3464500,11/1/2014
Enterprise,4, Velo , Low ,923,120000,125000,115375000,1153750,114221250,110760000,3461250,8/1/2014
Government,3, Amarilla , None ,1686,260000,7000,11802000,0,11802000,8430000,3372000,7/1/2014
Government,3, Velo , Medium ,2338,120000,7000,16366000,1309280,15056720,11690000,3366720,6/1/2014
Government,3, VTT , Medium ,2338,250000,7000,16366000,1309280,15056720,11690000,3366720,6/1/2014
Government,5, Carretera , High ,2706,3000,7000,18942000,2083620,16858380,13530000,3328380,11/1/2013
Channel Partners,3, Paseo , None ,367,10000,12000,4404000,0,4404000,1101000,3303000,7/1/2014
Government,3, Carretera , High ,442,3000,20000,8840000,1149200,7690800,4420000,3270800,9/1/2013
Midmarket,3, Paseo , High ,1175,10000,15000,17625000,2643750,14981250,11750000,3231250,10/1/2014
Midmarket,3, VTT , High ,1175,250000,15000,17625000,2643750,14981250,11750000,3231250,10/1/2014
Government,3, Paseo , Medium ,2125,10000,7000,14875000,1041250,13833750,10625000,3208750,12/1/2013
Government,4, Montana , High ,2734,5000,7000,19138000,2296560,16841440,13670000,3171440,10/1/2014
Government,4, Amarilla , High ,2734,260000,7000,19138000,2296560,16841440,13670000,3171440,10/1/2014
Government,5, Paseo , Low ,1760,10000,7000,12320000,369600,11950400,8800000,3150400,9/1/2013
Government,2, Paseo , High ,2532,10000,7000,17724000,1949640,15774360,12660000,3114360,4/1/2014
Midmarket,1, Montana , None ,615,5000,15000,9225000,0,9225000,6150000,3075000,12/1/2014
Midmarket,1, Amarilla , None ,615,260000,15000,9225000,0,9225000,6150000,3075000,12/1/2014
Government,1, Carretera , High ,2996,3000,7000,20972000,2936080,18035920,14980000,3055920,10/1/2013
Government,1, Montana , High ,2996,5000,7000,20972000,2936080,18035920,14980000,3055920,10/1/2013
Channel Partners,5, Velo , High ,410,120000,12000,4920000,639600,4280400,1230000,3050400,10/1/2014
Channel Partners,5, Amarilla , High ,410,260000,12000,4920000,639600,4280400,1230000,3050400,10/1/2014
Government,1, Montana , High ,2328,5000,7000,16296000,1629600,14666400,11640000,3026400,9/1/2014
Channel Partners,1, Carretera , High ,386,3000,12000,4632000,463200,4168800,1158000,3010800,10/1/2013
Channel Partners,1, Paseo , High ,386,10000,12000,4632000,463200,4168800,1158000,3010800,10/1/2013
Government,5, Velo , None ,1493,120000,7000,10451000,0,10451000,7465000,2986000,1/1/2014
Government,5, VTT , High ,2903,250000,7000,20321000,2844940,17476060,14515000,2961060,3/1/2014
Midmarket,1, Paseo , Low ,671,10000,15000,10065000,402600,9662400,6710000,2952400,10/1/2013
Midmarket,1, Amarilla , Low ,671,260000,15000,10065000,402600,9662400,6710000,2952400,10/1/2013
Enterprise,2, Paseo , Low ,787,10000,125000,98375000,983750,97391250,94440000,2951250,6/1/2014
Enterprise,2, VTT , Low ,787,250000,125000,98375000,983750,97391250,94440000,2951250,6/1/2014
Government,2, Paseo , High ,2696,10000,7000,18872000,2453360,16418640,13480000,2938640,8/1/2014
Government,4, Paseo , None ,292,10000,20000,5840000,0,5840000,2920000,2920000,2/1/2014
Channel Partners,5, Carretera , Medium ,367,3000,12000,4404000,396360,4007640,1101000,2906640,10/1/2013
Channel Partners,5, Paseo , Medium ,367,10000,12000,4404000,396360,4007640,1101000,2906640,10/1/2013
Government,5, Montana , High ,2420,5000,7000,16940000,2032800,14907200,12100000,2807200,9/1/2014
Government,5, Paseo , Medium ,1946,10000,7000,13622000,1089760,12532240,9730000,2802240,12/1/2013
Government,5, Amarilla , Medium ,1683,260000,7000,11781000,589050,11191950,8415000,2776950,7/1/2014
Midmarket,1, Velo , High ,790,120000,15000,11850000,1185000,10665000,7900000,2765000,5/1/2014
Midmarket,2, Paseo , None ,549,10000,15000,8235000,0,8235000,5490000,2745000,9/1/2013
Small Business,5, Montana , High ,546,5000,300000,163800000,24570000,139230000,136500000,2730000,10/1/2014
Small Business,5, Amarilla , High ,546,260000,300000,163800000,24570000,139230000,136500000,2730000,10/1/2014
Enterprise,1, Paseo , Low ,727,10000,125000,90875000,908750,89966250,87240000,2726250,6/1/2014
Enterprise,1, VTT , Low ,727,250000,125000,90875000,908750,89966250,87240000,2726250,6/1/2014
Midmarket,3, Montana , Medium ,711,5000,15000,10665000,853200,9811800,7110000,2701800,12/1/2014
Midmarket,3, Amarilla , Medium ,711,260000,15000,10665000,853200,9811800,7110000,2701800,12/1/2014
Government,4, VTT , Low ,1326,250000,7000,9282000,92820,9189180,6630000,2559180,3/1/2014
Enterprise,4, Paseo , Low ,2009,10000,125000,251125000,7533750,243591250,241080000,2511250,10/1/2014
Enterprise,4, Velo , Low ,2009,120000,125000,251125000,7533750,243591250,241080000,2511250,10/1/2014
Enterprise,1, Montana , Low ,663,5000,125000,82875000,828750,82046250,79560000,2486250,10/1/2013
Enterprise,1, Velo , Low ,663,120000,125000,82875000,828750,82046250,79560000,2486250,10/1/2013
Channel Partners,2, Amarilla , Medium ,306,260000,12000,3672000,330480,3341520,918000,2423520,12/1/2013
Government,5, Paseo , High ,2535,10000,7000,17745000,2661750,15083250,12675000,2408250,4/1/2014
Government,4, Velo , Medium ,1582,120000,7000,11074000,775180,10298820,7910000,2388820,12/1/2014
Government,4, VTT , Medium ,1582,250000,7000,11074000,775180,10298820,7910000,2388820,12/1/2014
Midmarket,3, Velo , High ,681,120000,15000,10215000,1021500,9193500,6810000,2383500,1/1/2014
Government,5, Velo , Medium ,1498,120000,7000,10486000,629160,9856840,7490000,2366840,6/1/2014
Government,5, VTT , Medium ,1498,250000,7000,10486000,629160,9856840,7490000,2366840,6/1/2014
Midmarket,1, Velo , Medium ,555,120000,15000,8325000,416250,7908750,5550000,2358750,1/1/2014
Government,3, Paseo , Medium ,1598,10000,7000,11186000,894880,10291120,7990000,2301120,8/1/2014
Government,1, Paseo , None ,1143,10000,7000,8001000,0,8001000,5715000,2286000,10/1/2014
Government,1, Amarilla , None ,1143,260000,7000,8001000,0,8001000,5715000,2286000,10/1/2014
Government,3, Paseo , Medium ,1372,10000,7000,9604000,480200,9123800,6860000,2263800,1/1/2014
Midmarket,5, VTT , High ,641,250000,15000,9615000,961500,8653500,6410000,2243500,7/1/2014
Government,4, Velo , High ,1808,120000,7000,12656000,1392160,11263840,9040000,2223840,11/1/2014
Enterprise,4, Paseo , Low ,1774,10000,125000,221750000,6652500,215097500,212880000,2217500,3/1/2014
Government,2, Montana , Medium ,1403,5000,7000,9821000,589260,9231740,7015000,2216740,10/1/2013
Government,2, Amarilla , Medium ,1403,260000,7000,9821000,589260,9231740,7015000,2216740,10/1/2013
Government,4, Montana , Medium ,1611,5000,7000,11277000,1014930,10262070,8055000,2207070,12/1/2013
Midmarket,5, Velo , High ,655,120000,15000,9825000,1080750,8744250,6550000,2194250,9/1/2013
Midmarket,1, Montana , High ,677,5000,15000,10155000,1218600,8936400,6770000,2166400,3/1/2014
Small Business,4, Velo , High ,269,120000,300000,80700000,11298000,69402000,67250000,2152000,10/1/2013
Small Business,4, VTT , High ,269,250000,300000,80700000,11298000,69402000,67250000,2152000,10/1/2013
Enterprise,3, Montana , Low ,1706,5000,125000,213250000,6397500,206852500,204720000,2132500,12/1/2014
Enterprise,3, Paseo , Low ,1706,10000,125000,213250000,6397500,206852500,204720000,2132500,12/1/2014
Government,5, Velo , Medium ,1333,120000,7000,9331000,559860,8771140,6665000,2106140,11/1/2014
Government,2, Paseo , High ,293,10000,20000,5860000,879000,4981000,2930000,2051000,12/1/2014
Government,2, VTT , High ,293,250000,20000,5860000,879000,4981000,2930000,2051000,12/1/2014
Enterprise,3, Paseo , Low ,809,10000,125000,101125000,2022500,99102500,97080000,2022500,10/1/2013
Enterprise,3, Velo , Low ,809,120000,125000,101125000,2022500,99102500,97080000,2022500,10/1/2013
Midmarket,3, Velo , High ,660,120000,15000,9900000,1287000,8613000,6600000,2013000,9/1/2013
Government,2, Paseo , Low ,1030,10000,7000,7210000,72100,7137900,5150000,1987900,5/1/2014
Enterprise,3, Paseo , Low ,1570,10000,125000,196250000,5887500,190362500,188400000,1962500,6/1/2014
Enterprise,3, VTT , Low ,1570,250000,125000,196250000,5887500,190362500,188400000,1962500,6/1/2014
Government,1, VTT , High ,1579,250000,7000,11053000,1215830,9837170,7895000,1942170,3/1/2014
Government,3, Paseo , High ,241,10000,20000,4820000,482000,4338000,2410000,1928000,10/1/2014
Government,3, Velo , High ,241,120000,20000,4820000,482000,4338000,2410000,1928000,10/1/2014
Government,3, Montana , Medium ,1159,5000,7000,8113000,405650,7707350,5795000,1912350,10/1/2013
Government,3, Amarilla , Medium ,1159,260000,7000,8113000,405650,7707350,5795000,1912350,10/1/2013
Government,5, Paseo , High ,260,10000,20000,5200000,728000,4472000,2600000,1872000,2/1/2014
Government,1, Paseo , High ,267,10000,20000,5340000,801000,4539000,2670000,1869000,10/1/2013
Government,1, VTT , High ,267,250000,20000,5340000,801000,4539000,2670000,1869000,10/1/2013
Midmarket,2, Carretera , Medium ,490,3000,15000,7350000,588000,6762000,4900000,1862000,11/1/2014
Enterprise,4, Carretera , Low ,742.5,3000,125000,92812500,1856250,90956250,89100000,1856250,4/1/2014
Government,3, Paseo , Medium ,1259,10000,7000,8813000,705040,8107960,6295000,1812960,4/1/2014
Midmarket,3, Velo , High ,510,120000,15000,7650000,765000,6885000,5100000,1785000,4/1/2014
Government,5, Paseo , None ,883,10000,7000,6181000,0,6181000,4415000,1766000,8/1/2014
Government,2, Paseo , High ,1731,10000,7000,12117000,1696380,10420620,8655000,1765620,10/1/2014
Government,2, Amarilla , High ,1731,260000,7000,12117000,1696380,10420620,8655000,1765620,10/1/2014
Government,5, Montana , High ,1727,5000,7000,12089000,1692460,10396540,8635000,1761540,10/1/2013
Government,5, Amarilla , High ,1727,260000,7000,12089000,1692460,10396540,8635000,1761540,10/1/2013
Government,2, VTT , High ,1491,250000,7000,10437000,1252440,9184560,7455000,1729560,3/1/2014
Enterprise,4, Montana , None ,345,5000,125000,43125000,0,43125000,41400000,1725000,10/1/2013
Enterprise,4, Velo , None ,345,120000,125000,43125000,0,43125000,41400000,1725000,10/1/2013
Government,4, Velo , Medium ,1135,120000,7000,7945000,556150,7388850,5675000,1713850,6/1/2014
Government,4, Amarilla , Medium ,1135,260000,7000,7945000,556150,7388850,5675000,1713850,6/1/2014
Government,3, Carretera , Medium ,1016,3000,7000,7112000,355600,6756400,5080000,1676400,11/1/2013
Enterprise,5, Paseo , Low ,662,10000,125000,82750000,1655000,81095000,79440000,1655000,6/1/2014
Enterprise,5, VTT , Low ,662,250000,125000,82750000,1655000,81095000,79440000,1655000,6/1/2014
Enterprise,2, Montana , Low ,1287,5000,125000,160875000,4826250,156048750,154440000,1608750,12/1/2014
Enterprise,2, Paseo , Low ,1287,10000,125000,160875000,4826250,156048750,154440000,1608750,12/1/2014
Government,3, Paseo , Medium ,1095,10000,7000,7665000,613200,7051800,5475000,1576800,5/1/2014
Government,1, Paseo , High ,1438.5,10000,7000,10069500,1309040,8760470,7192500,1567970,1/1/2014
Midmarket,2, Amarilla , Low ,321,260000,15000,4815000,48150,4766850,3210000,1556850,11/1/2013
Government,2, Paseo , Medium ,1031,10000,7000,7217000,505190,6711810,5155000,1556810,9/1/2013
Government,1, Montana , High ,1298,5000,7000,9086000,1181180,7904820,6490000,1414820,2/1/2014
Midmarket,3, VTT , High ,492,250000,15000,7380000,1107000,6273000,4920000,1353000,7/1/2014
Government,5, Montana , High ,1368,5000,7000,9576000,1436400,8139600,6840000,1299600,2/1/2014
Government,2, Velo , High ,1190,120000,7000,8330000,1082900,7247100,5950000,1297100,6/1/2014
Government,2, Amarilla , High ,1190,260000,7000,8330000,1082900,7247100,5950000,1297100,6/1/2014
Midmarket,4, Velo , High ,384,120000,15000,5760000,633600,5126400,3840000,1286400,1/1/2014
Enterprise,1, Carretera , Low ,330,3000,125000,41250000,412500,40837500,39600000,1237500,9/1/2013
Government,2, Velo , Low ,639,120000,7000,4473000,44730,4428270,3195000,1233270,11/1/2014
Midmarket,5, Paseo , High ,380,10000,15000,5700000,684000,5016000,3800000,1216000,12/1/2013
Government,4, Carretera , Medium ,819,3000,7000,5733000,515970,5217030,4095000,1122030,7/1/2014
Government,1, Paseo , Medium ,678,10000,7000,4746000,379680,4366320,3390000,976320,8/1/2014
Government,2, Montana , Low ,544,5000,7000,3808000,114240,3693760,2720000,973760,9/1/2014
Midmarket,4, Paseo , Low ,218,10000,15000,3270000,130800,3139200,2180000,959200,9/1/2014
Government,1, Carretera , Medium ,570,3000,7000,3990000,199500,3790500,2850000,940500,12/1/2014
Government,1, VTT , Medium ,570,250000,7000,3990000,199500,3790500,2850000,940500,12/1/2014
Midmarket,5, Velo , Medium ,245,120000,15000,3675000,330750,3344250,2450000,894250,5/1/2014
Government,1, Velo , Medium ,547,120000,7000,3829000,268030,3560970,2735000,825970,11/1/2014
Midmarket,3, Paseo , High ,278,10000,15000,4170000,583800,3586200,2780000,806200,2/1/2014
Government,5, Carretera , Medium ,521,3000,7000,3647000,328230,3318770,2605000,713770,12/1/2014
Government,5, VTT , Medium ,521,250000,7000,3647000,328230,3318770,2605000,713770,12/1/2014
Government,4, Montana , Medium ,488,5000,7000,3416000,273280,3142720,2440000,702720,2/1/2014
Government,5, Velo , Low ,362,120000,7000,2534000,25340,2508660,1810000,698660,5/1/2014
Government,4, Paseo , High ,723,10000,7000,5061000,759150,4301850,3615000,686850,4/1/2014
Government,3, VTT , Low ,263,250000,7000,1841000,18410,1822590,1315000,507590,3/1/2014
Government,3, Paseo , Medium ,360,10000,7000,2520000,226800,2293200,1800000,493200,10/1/2014
Government,3, VTT , Medium ,360,250000,7000,2520000,226800,2293200,1800000,493200,10/1/2014
Government,1, Paseo , High ,380,10000,7000,2660000,292600,2367400,1900000,467400,9/1/2013
Government,1, Carretera , Medium ,263,3000,7000,1841000,110460,1730540,1315000,415540,11/1/2013
Government,4, Montana , High ,388,5000,7000,2716000,380240,2335760,1940000,395760,9/1/2014
Government,4, Paseo , Medium ,257,10000,7000,1799000,143920,1655080,1285000,370080,5/1/2014
Government,2, Montana , High ,293,5000,7000,2051000,287140,1763860,1465000,298860,2/1/2014
Government,3, Carretera , High ,280,3000,7000,1960000,274400,1685600,1400000,285600,12/1/2014
Government,3, VTT , High ,280,250000,7000,1960000,274400,1685600,1400000,285600,12/1/2014
Enterprise,5, Montana , Low ,1138,5000,125000,142250000,5690000,136560000,136560000,0,12/1/2014
Enterprise,3, Paseo , Low ,795,10000,125000,99375000,3975000,95400000,95400000,0,3/1/2014
Enterprise,2, Paseo , Low ,2988,10000,125000,373500000,14940000,358560000,358560000,0,7/1/2014
Enterprise,5, Paseo , Low ,1138,10000,125000,142250000,5690000,136560000,136560000,0,12/1/2014
Enterprise,5, Amarilla , Low ,1074,260000,125000,134250000,5370000,128880000,128880000,0,4/1/2014
Enterprise,2, Paseo , Medium ,704,10000,125000,88000000,4400000,83600000,84480000,-880000,10/1/2013
Enterprise,2, Velo , Medium ,704,120000,125000,88000000,4400000,83600000,84480000,-880000,10/1/2013
Enterprise,3, Velo , Medium ,807,120000,125000,100875000,5043750,95831250,96840000,-1008750,2/1/2014
Enterprise,1, Paseo , Medium ,861,10000,125000,107625000,5381250,102243750,103320000,-1076250,10/1/2014
Enterprise,1, Velo , Medium ,861,120000,125000,107625000,5381250,102243750,103320000,-1076250,10/1/2014
Enterprise,3, Carretera , Medium ,887,3000,125000,110875000,6652500,104222500,106440000,-2217500,12/1/2013
Enterprise,4, Velo , Medium ,952,120000,125000,119000000,7140000,111860000,114240000,-2380000,2/1/2014
Enterprise,5, VTT , High ,341,250000,125000,42625000,4262500,38362500,40920000,-2557500,5/1/2014
Enterprise,2, Paseo , Medium ,2385,10000,125000,298125000,14906250,283218750,286200000,-2981250,3/1/2014
Enterprise,4, Velo , Medium ,567,120000,125000,70875000,6378750,64496250,68040000,-3543750,9/1/2014
Enterprise,3, Amarilla , Medium ,994,260000,125000,124250000,8697500,115552500,119280000,-3727500,9/1/2013
Enterprise,1, Paseo , Medium ,2992,10000,125000,374000000,18700000,355300000,359040000,-3740000,3/1/2014
Enterprise,1, Amarilla , High ,579,260000,125000,72375000,7237500,65137500,69480000,-4342500,1/1/2014
Enterprise,1, Montana , Medium ,3627,5000,125000,453375000,22668750,430706250,435240000,-4533750,7/1/2014
Enterprise,5, VTT , High ,554,250000,125000,69250000,7617500,61632500,66480000,-4847500,1/1/2014
Enterprise,2, Amarilla , Medium ,1987.5,260000,125000,248437500,14906250,233531250,238500000,-4968750,1/1/2014
Enterprise,5, VTT , Medium ,877,250000,125000,109625000,9866250,99758750,105240000,-5481250,11/1/2014
Enterprise,5, Paseo , Medium ,1114,10000,125000,139250000,11140000,128110000,133680000,-5570000,3/1/2014
Enterprise,4, Amarilla , Medium ,1645,260000,125000,205625000,14393750,191231250,197400000,-6168750,5/1/2014
Enterprise,1, Velo , Medium ,2755,120000,125000,344375000,20662500,323712500,330600000,-6887500,2/1/2014
Enterprise,3, VTT , High ,552,250000,125000,69000000,10350000,58650000,66240000,-7590000,11/1/2014
Enterprise,5, Carretera , Medium ,1540,3000,125000,192500000,15400000,177100000,184800000,-7700000,8/1/2014
Enterprise,3, Velo , Medium ,2087,120000,125000,260875000,18261250,242613750,250440000,-7826250,9/1/2014
Enterprise,5, Amarilla , High ,947,260000,125000,118375000,13021250,105353750,113640000,-8286250,9/1/2013
Enterprise,2, Velo , High ,663,120000,125000,82875000,12431250,70443750,79560000,-9116250,9/1/2014
Enterprise,3, Montana , Medium ,2500,5000,125000,312500000,21875000,290625000,300000000,-9375000,11/1/2013
Enterprise,2, Carretera , High ,1482,3000,125000,185250000,18525000,166725000,177840000,-11115000,12/1/2013
Enterprise,2, Montana , Medium ,1857,5000,125000,232125000,20891250,211233750,222840000,-11606250,11/1/2013
Enterprise,1, Velo , High ,1596,120000,125000,199500000,19950000,179550000,191520000,-11970000,9/1/2014
Enterprise,2, Amarilla , High ,1433,260000,125000,179125000,19703750,159421250,171960000,-12538750,5/1/2014
Enterprise,2, Carretera , High ,1023,3000,125000,127875000,17902500,109972500,122760000,-12787500,9/1/2013
Enterprise,3, Paseo , Medium ,3513,10000,125000,439125000,30738750,408386250,421560000,-13173750,7/1/2014
Enterprise,5, Velo , Medium ,2110,120000,125000,263750000,23737500,240012500,253200000,-13187500,9/1/2014
Enterprise,1, Montana , High ,1804,5000,125000,225500000,22550000,202950000,216480000,-13530000,11/1/2013
Enterprise,4, Velo , High ,1916,120000,125000,239500000,23950000,215550000,229920000,-14370000,12/1/2013
Enterprise,3, Carretera , High ,1085,3000,125000,135625000,20343750,115281250,130200000,-14918750,10/1/2014
Enterprise,3, Paseo , High ,1085,10000,125000,135625000,20343750,115281250,130200000,-14918750,10/1/2014
Enterprise,2, Carretera , High ,1174,3000,125000,146750000,22012500,124737500,140880000,-16142500,8/1/2014
Enterprise,1, Montana , Medium ,2797,5000,125000,349625000,31466250,318158750,335640000,-17481250,12/1/2014
Enterprise,1, Paseo , Medium ,2797,10000,125000,349625000,31466250,318158750,335640000,-17481250,12/1/2014
Enterprise,4, Paseo , High ,1583,10000,125000,197875000,25723750,172151250,189960000,-17808750,6/1/2014
Enterprise,4, VTT , High ,1583,250000,125000,197875000,25723750,172151250,189960000,-17808750,6/1/2014
Enterprise,4, Amarilla , High ,1659,260000,125000,207375000,26958750,180416250,199080000,-18663750,1/1/2014
Enterprise,4, VTT , High ,2529,250000,125000,316125000,31612500,284512500,303480000,-18967500,11/1/2014
Enterprise,5, Velo , High ,1575,120000,125000,196875000,27562500,169312500,189000000,-19687500,2/1/2014
Enterprise,2, Carretera , High ,2441,3000,125000,305125000,33563750,271561250,292920000,-21358750,10/1/2014
Enterprise,2, Paseo , High ,2441,10000,125000,305125000,33563750,271561250,292920000,-21358750,10/1/2014
Enterprise,5, Carretera , High ,2156,3000,125000,269500000,32340000,237160000,258720000,-21560000,10/1/2014
Enterprise,5, Paseo , High ,2156,10000,125000,269500000,32340000,237160000,258720000,-21560000,10/1/2014
Enterprise,1, VTT , High ,2387,250000,125000,298375000,35805000,262570000,286440000,-23870000,11/1/2014
Enterprise,4, Carretera , High ,2416,3000,125000,302000000,36240000,265760000,289920000,-24160000,9/1/2013
Enterprise,1, Carretera , High ,3445.5,3000,125000,430687500,43068750,387618750,413460000,-25841250,4/1/2014
Enterprise,3, Amarilla , High ,3165,260000,125000,395625000,43518750,352106250,379800000,-27693750,1/1/2014
Enterprise,1, Velo , High ,2438,120000,125000,304750000,45712500,259037500,292560000,-33522500,12/1/2013
Enterprise,5, Carretera , High ,2821,3000,125000,352625000,49367500,303257500,338520000,-35262500,12/1/2013
Enterprise,1, Amarilla , High ,2844,260000,125000,355500000,49770000,305730000,341280000,-35550000,5/1/2014
Enterprise,3, Carretera , High ,2767,3000,125000,345875000,51881250,293993750,332040000,-38046250,8/1/2014
Enterprise,4, VTT , High ,2954,250000,125000,369250000,55387500,313862500,354480000,-40617500,11/1/2013
