ID,Gender,Birth_Year,Seq,1st_LC_Score,1st_RC_Score,1st_Total_Score,2st_LC_Score,2st_RC_Score,2st_Total_Score,3st_LC_Score,3st_RC_Score,3st_Total_Score,Score_diff_total,학습목표,학습방법,강의 학습 교재 유형,학습빈도,기출문제 공부 횟수,취약분야 인지 여부,토익 모의테스트 횟수
1,M,1973,3,181,173,354,227,213,440,345,336,681,241,승진,온라인강의,영상 교재,주5-6회,7,알고 있음,10
2,F,1982,3,330,290,620,354,339,693,380,368,748,55,승진,온라인강의,뉴스/이슈 기반 교재,주5-6회,4,알고 있음,14
3,F,1995,3,367,309,676,396,365,761,416,382,798,37,자기계발,참고서,일반적인 영어 텍스트 기반 교재,주1-2회,4,알고 있음,4
4,M,1987,3,470,285,755,495,341,836,495,397,892,56,승진,온라인강의,뉴스/이슈 기반 교재,주3-4회,9,알고 있음,8
5,M,1994,3,273,372,645,314,426,740,398,437,835,95,자기계발,온라인강의,영상 교재,주3-4회,6,알고 있음,4
6,F,1997,3,360,256,616,372,269,641,445,352,797,156,취업,온라인강의,영상 교재,주5-6회,9,알고 있음,7
7,F,1990,3,487,337,824,495,341,836,495,382,877,41,자기계발,오프라인강의,비즈니스 시뮬레이션(Role Play),주1-2회,4,알고 있음,4
8,M,1973,3,132,129,261,133,130,263,145,135,280,17,자기계발,오프라인강의,비즈니스 시뮬레이션(Role Play),주3-4회,7,알고 있지 않음,7
9,M,1994,3,256,369,625,322,425,747,354,457,811,64,승진,온라인강의,뉴스/이슈 기반 교재,주5-6회,8,알고 있음,10
10,F,1984,3,358,279,637,382,305,687,423,346,769,82,승진,온라인강의,영상 교재,주5-6회,8,알고 있음,8
11,F,1991,3,447,234,681,452,297,749,457,309,766,17,자기계발,참고서,일반적인 영어 텍스트 기반 교재,주1-2회,3,알고 있음,6
12,M,2007,3,300,413,713,332,445,777,368,476,844,67,자기계발,온라인강의,뉴스/이슈 기반 교재,주3-4회,5,알고 있음,6
13,M,1991,3,406,321,727,443,388,831,484,429,913,82,승진,참고서,일반적인 영어 텍스트 기반 교재,주5-6회,6,알고 있음,9
14,F,1986,3,432,273,705,469,310,779,470,342,812,33,승진,참고서,일반적인 영어 텍스트 기반 교재,주5-6회,8,알고 있음,7
15,F,2005,3,487,235,722,489,265,754,490,329,819,65,자기계발,온라인강의,뉴스/이슈 기반 교재,주3-4회,4,알고 있음,6
16,M,1990,3,465,400,865,466,429,895,469,488,957,62,자기계발,오프라인강의,비즈니스 시뮬레이션(Role Play),주3-4회,6,알고 있음,5
17,M,1999,3,437,403,840,440,432,872,472,464,936,64,자기계발,온라인강의,뉴스/이슈 기반 교재,주3-4회,4,알고 있음,5
18,F,2005,3,363,454,817,392,455,847,435,495,930,83,자기계발,온라인강의,영상 교재,주5-6회,8,알고 있음,9
19,F,1992,3,370,339,709,436,375,811,440,439,879,68,자기계발,오프라인강의,비즈니스 시뮬레이션(Role Play),주5-6회,7,알고 있음,8
20,M,1995,3,174,275,449,245,279,524,295,295,590,66,승진,오프라인강의,비즈니스 시뮬레이션(Role Play),매일(주 7회),10,알고 있음,6
21,F,1997,3,359,331,690,415,387,802,432,428,860,58,자기계발,온라인강의,영상 교재,주3-4회,5,알고 있음,7
22,M,1988,3,336,267,603,359,283,642,401,325,726,84,자기계발,오프라인강의,비즈니스 시뮬레이션(Role Play),주1-2회,2,알고 있음,4
23,F,1984,3,469,289,758,471,380,851,472,409,881,30,승진,참고서,일반적인 영어 텍스트 기반 교재,주5-6회,6,알고 있음,8
24,M,2002,3,306,231,537,308,239,547,391,322,713,166,취업,온라인강의,영상 교재,주1-2회,3,알고 있음,4
25,F,1992,3,322,478,800,340,479,819,348,480,828,9,자기계발,온라인강의,뉴스/이슈 기반 교재,주5-6회,5,알고 있지 않음,9
26,M,1998,3,369,385,754,399,415,814,433,449,882,68,자기계발,오프라인강의,비즈니스 시뮬레이션(Role Play),주3-4회,6,알고 있음,7
27,F,1991,3,255,357,612,280,382,662,327,429,756,94,자기계발,온라인강의,뉴스/이슈 기반 교재,주3-4회,4,알고 있지 않음,8
28,M,1985,3,309,341,650,334,366,700,383,415,798,98,자기계발,오프라인강의,비즈니스 시뮬레이션(Role Play),매일(주 7회),9,알고 있음,14
29,F,1986,3,290,376,666,320,406,726,371,457,828,102,자기계발,온라인강의,영상 교재,주3-4회,4,알고 있음,8
30,M,1986,3,474,339,813,475,390,865,483,416,899,34,승진,온라인강의,비즈니스 시뮬레이션(Role Play),주1-2회,2,알고 있음,4
31,F,1985,3,476,334,810,479,391,870,482,412,894,24,승진,참고서,일반적인 영어 텍스트 기반 교재,주3-4회,5,알고 있음,10
32,M,1993,3,355,355,710,404,403,807,461,460,921,114,자기계발,온라인강의,영상 교재,매일(주 7회),9,알고 있지 않음,17
33,F,2006,3,341,413,754,368,440,808,404,476,880,72,자기계발,온라인강의,영상 교재,주3-4회,3,알고 있음,6
34,M,2007,3,368,318,686,400,350,750,436,386,822,72,자기계발,온라인강의,영상 교재,주3-4회,4,알고 있음,8
35,F,2000,3,291,357,648,328,394,722,360,426,786,64,자기계발,온라인강의,영상 교재,주1-2회,2,알고 있음,5
36,M,1983,3,328,248,576,380,300,680,382,308,690,10,승진,참고서,일반적인 영어 텍스트 기반 교재,주1-2회,2,알고 있지 않음,5
37,F,2004,3,353,251,604,421,319,740,426,327,753,13,자기계발,참고서,일반적인 영어 텍스트 기반 교재,주1-2회,2,알고 있음,3
38,M,1993,3,447,314,761,491,358,849,493,389,882,33,자기계발,참고서,일반적인 영어 텍스트 기반 교재,주5-6회,7,알고 있음,12
39,F,2003,3,357,282,639,389,314,703,392,320,712,9,자기계발,참고서,일반적인 영어 텍스트 기반 교재,주1-2회,1,알고 있음,4
40,M,2003,3,277,242,519,307,245,552,343,281,624,72,자기계발,온라인강의,영상 교재,주3-4회,6,알고 있음,12
41,F,2000,3,413,240,653,415,324,739,416,339,755,16,자기계발,참고서,일반적인 영어 텍스트 기반 교재,주1-2회,2,알고 있음,5
42,M,2002,3,297,482,779,399,484,883,412,485,897,14,자기계발,참고서,일반적인 영어 텍스트 기반 교재,주1-2회,3,알고 있음,7
43,F,1995,3,371,298,669,417,344,761,454,381,835,74,승진,온라인강의,뉴스/이슈 기반 교재,주5-6회,7,알고 있음,14
44,M,2006,3,289,307,596,326,344,670,331,349,680,10,자기계발,참고서,일반적인 영어 텍스트 기반 교재,주1-2회,1,알고 있음,3
45,F,1982,3,431,484,915,495,488,983,495,495,990,7,자기계발,오프라인강의,비즈니스 시뮬레이션(Role Play),주3-4회,6,알고 있음,11
46,M,1973,3,283,241,524,295,272,567,319,296,615,48,승진,오프라인강의,비즈니스 시뮬레이션(Role Play),주1-2회,2,알고 있음,4
47,F,1988,3,262,294,556,283,315,598,322,354,676,78,승진,오프라인강의,비즈니스 시뮬레이션(Role Play),주3-4회,4,알고 있지 않음,8
48,M,1990,3,494,236,730,495,349,844,495,387,882,38,자기계발,참고서,일반적인 영어 텍스트 기반 교재,매일(주 7회),8,알고 있음,18
49,F,1995,3,492,310,802,493,342,835,495,375,870,35,자기계발,참고서,일반적인 영어 텍스트 기반 교재,주1-2회,2,알고 있음,5
50,M,1994,3,279,290,569,309,300,609,348,339,687,78,승진,오프라인강의,비즈니스 시뮬레이션(Role Play),주3-4회,3,알고 있음,6
51,F,1999,3,362,327,689,363,357,720,456,450,906,186,취업,온라인강의,영상 교재,주5-6회,7,알고 있음,15
52,M,1998,3,283,325,608,335,377,712,346,378,724,12,승진,참고서,일반적인 영어 텍스트 기반 교재,주1-2회,2,알고 있음,4
53,F,2007,3,440,329,769,472,361,833,475,369,844,11,자기계발,참고서,일반적인 영어 텍스트 기반 교재,주1-2회,1,알고 있음,3
54,M,2007,3,371,266,637,398,293,691,408,303,711,20,자기계발,참고서,일반적인 영어 텍스트 기반 교재,주3-4회,4,알고 있음,8
55,F,1994,3,407,286,693,415,369,784,452,406,858,74,승진,온라인강의,뉴스/이슈 기반 교재,주5-6회,6,알고 있음,12
56,M,1994,3,289,297,586,319,328,647,334,344,678,31,승진,참고서,일반적인 영어 텍스트 기반 교재,주5-6회,8,알고 있음,15
57,F,1986,3,271,399,670,302,400,702,353,452,805,103,자기계발,온라인강의,영상 교재,주3-4회,5,알고 있지 않음,9
58,M,1987,3,270,430,700,302,462,764,358,494,852,88,승진,오프라인강의,비즈니스 시뮬레이션(Role Play),주3-4회,4,알고 있음,7
59,F,1986,3,266,486,752,375,489,864,433,491,924,60,승진,오프라인강의,비즈니스 시뮬레이션(Role Play),주3-4회,5,알고 있지 않음,6
60,M,1984,3,349,245,594,379,275,654,431,327,758,104,자기계발,온라인강의,뉴스/이슈 기반 교재,주5-6회,6,알고 있음,10
61,F,1984,3,360,317,677,362,358,720,392,392,784,64,승진,오프라인강의,비즈니스 시뮬레이션(Role Play),주5-6회,7,알고 있음,8
62,M,2006,3,448,309,757,449,320,769,452,392,844,75,자기계발,온라인강의,뉴스/이슈 기반 교재,주5-6회,7,알고 있지 않음,8
63,F,1992,3,287,307,594,328,322,650,338,329,667,17,승진,참고서,일반적인 영어 텍스트 기반 교재,주3-4회,6,알고 있음,9
64,M,1997,3,312,435,747,380,440,820,479,474,953,133,취업,참고서,일반적인 영어 텍스트 기반 교재,매일(주 7회),8,알고 있음,15
65,F,2002,3,465,242,707,467,253,720,468,307,775,55,자기계발,온라인강의,뉴스/이슈 기반 교재,주1-2회,2,알고 있음,4
66,M,1991,3,295,477,772,355,480,835,449,481,930,95,자기계발,온라인강의,뉴스/이슈 기반 교재,주3-4회,5,알고 있음,9
67,F,1996,3,324,332,656,300,374,674,320,394,714,40,자기계발,참고서,일반적인 영어 텍스트 기반 교재,주1-2회,3,알고 있지 않음,4
68,M,1998,3,381,291,672,413,326,739,444,357,801,62,자기계발,참고서,일반적인 영어 텍스트 기반 교재,주5-6회,6,알고 있음,7
69,F,1988,3,313,321,634,324,325,649,376,351,727,78,자기계발,오프라인강의,비즈니스 시뮬레이션(Role Play),주5-6회,7,알고 있음,13
70,M,1990,3,181,174,355,201,194,395,232,225,457,62,자기계발,참고서,일반적인 영어 텍스트 기반 교재,주5-6회,7,알고 있음,12
71,F,2006,3,279,396,675,310,427,737,321,438,759,22,자기계발,참고서,일반적인 영어 텍스트 기반 교재,주3-4회,4,알고 있음,6
72,M,1993,3,319,319,638,325,321,646,382,378,760,114,자기계발,온라인강의,뉴스/이슈 기반 교재,주5-6회,7,알고 있음,10
73,F,1981,3,316,327,643,321,328,649,382,409,791,142,승진,온라인강의,뉴스/이슈 기반 교재,주5-6회,8,알고 있음,12
74,M,1997,3,259,467,726,309,468,777,338,470,808,31,승진,참고서,일반적인 영어 텍스트 기반 교재,주5-6회,5,알고 있지 않음,10
75,F,1996,3,371,328,699,419,365,784,465,485,950,166,취업,온라인강의,영상 교재,주1-2회,2,알고 있음,3
76,M,1985,3,254,124,378,286,194,480,291,209,500,20,자기계발,참고서,일반적인 영어 텍스트 기반 교재,매일(주 7회),10,알고 있음,17
77,F,2006,3,365,312,677,378,358,736,387,412,799,63,자기계발,온라인강의,뉴스/이슈 기반 교재,주1-2회,3,알고 있음,2
78,M,1994,3,297,287,584,317,321,638,321,328,649,11,자기계발,오프라인강의,비즈니스 시뮬레이션(Role Play),주1-2회,1,알고 있음,4
79,F,1984,3,307,253,560,327,278,605,337,283,620,15,승진,오프라인강의,비즈니스 시뮬레이션(Role Play),주3-4회,5,알고 있음,9
80,M,1989,3,273,296,569,307,330,637,337,360,697,60,자기계발,참고서,일반적인 영어 텍스트 기반 교재,매일(주 7회),9,알고 있음,20
81,F,1991,3,261,348,609,308,395,703,337,424,761,58,승진,오프라인강의,비즈니스 시뮬레이션(Role Play),주3-4회,5,알고 있음,11
82,M,1993,3,362,287,649,412,314,726,431,356,787,61,자기계발,온라인강의,뉴스/이슈 기반 교재,주1-2회,2,알고 있음,4
83,F,2000,3,285,84,369,286,147,433,291,152,443,10,자기계발,참고서,일반적인 영어 텍스트 기반 교재,주1-2회,1,알고 있음,5
84,M,1999,3,488,378,866,493,383,876,495,445,940,64,자기계발,온라인강의,뉴스/이슈 기반 교재,주3-4회,6,알고 있지 않음,13
85,F,1988,3,269,267,536,331,301,632,337,312,649,17,자기계발,참고서,일반적인 영어 텍스트 기반 교재,주5-6회,7,알고 있음,15
86,M,1990,3,309,321,630,312,332,644,315,334,649,5,승진,오프라인강의,비즈니스 시뮬레이션(Role Play),주5-6회,7,알고 있음,16
87,F,1992,3,153,228,381,200,275,475,278,331,609,134,자기계발,오프라인강의,비즈니스 시뮬레이션(Role Play),주5-6회,7,알고 있음,13
88,M,1986,3,424,456,880,487,495,982,495,495,990,8,자기계발,오프라인강의,비즈니스 시뮬레이션(Role Play),주3-4회,3,알고 있음,13
89,F,1992,3,255,451,706,297,493,790,355,494,849,59,승진,오프라인강의,비즈니스 시뮬레이션(Role Play),주3-4회,4,알고 있음,8
90,M,1989,3,190,186,376,201,198,399,220,213,433,34,승진,참고서,일반적인 영어 텍스트 기반 교재,주3-4회,4,알고 있음,7
91,F,1993,3,301,328,629,321,321,642,322,327,649,7,자기계발,온라인강의,영상 교재,주1-2회,2,알고 있음,2
92,M,2007,3,491,479,970,495,495,990,495,495,990,0,자기계발,온라인강의,영상 교재,주3-4회,5,알고 있음,10
93,F,1987,3,274,264,538,312,289,601,327,322,649,48,승진,온라인강의,뉴스/이슈 기반 교재,주5-6회,6,알고 있음,8
94,M,1992,3,370,330,700,375,345,720,468,438,906,186,취업,온라인강의,영상 교재,주5-6회,4,알고 있지 않음,15
95,F,2005,3,293,395,688,330,432,762,339,433,772,10,자기계발,참고서,일반적인 영어 텍스트 기반 교재,주1-2회,1,알고 있음,2
96,M,1994,3,433,442,875,443,453,896,495,495,990,94,취업,온라인강의,영상 교재,주1-2회,2,알고 있음,3
97,F,1975,3,451,235,686,452,294,746,454,396,850,104,자기계발,온라인강의,영상 교재,주3-4회,4,알고 있음,8
98,M,2006,3,298,291,589,301,325,626,319,331,650,24,자기계발,온라인강의,뉴스/이슈 기반 교재,매일(주 7회),10,알고 있음,18
99,F,2006,3,392,351,743,393,360,753,420,387,807,54,자기계발,온라인강의,뉴스/이슈 기반 교재,주1-2회,2,알고 있음,4
100,M,1994,3,355,365,720,380,390,770,395,395,790,20,자기계발,참고서,일반적인 영어 텍스트 기반 교재,주1-2회,2,알고 있음,1
101,F,2002,3,303,268,571,322,278,600,351,318,669,69,자기계발,오프라인강의,뉴스/이슈 기반 교재,주3-4회,5,알고 있음,9
102,M,1984,3,198,312,510,309,331,640,316,327,643,3,승진,오프라인강의,비즈니스 시뮬레이션(Role Play),주3-4회,3,알고 있음,7
103,F,2005,3,290,429,719,373,430,803,382,431,813,10,자기계발,참고서,일반적인 영어 텍스트 기반 교재,주1-2회,1,알고 있음,4
104,M,1990,3,293,281,574,351,301,652,410,354,764,112,자기계발,참고서,일반적인 영어 텍스트 기반 교재,주5-6회,5,알고 있음,12
105,F,2005,3,253,285,538,262,286,548,295,295,590,42,자기계발,온라인강의,뉴스/이슈 기반 교재,주5-6회,4,알고 있음,15
106,M,1986,3,373,470,843,412,471,883,468,473,941,58,승진,오프라인강의,비즈니스 시뮬레이션(Role Play),주3-4회,5,알고 있음,6
107,F,1990,3,311,341,652,314,342,656,365,394,759,103,자기계발,온라인강의,영상 교재,주3-4회,5,알고 있음,9
108,M,1995,3,348,448,796,495,467,962,495,495,990,28,자기계발,참고서,일반적인 영어 텍스트 기반 교재,주1-2회,2,알고 있음,2
109,F,1989,3,491,475,966,495,495,990,495,495,990,0,자기계발,참고서,일반적인 영어 텍스트 기반 교재,주3-4회,4,알고 있음,8
110,M,1994,3,475,470,945,495,495,990,495,495,990,0,자기계발,온라인강의,영상 교재,매일(주 7회),9,알고 있음,19
111,F,1987,3,344,391,735,359,406,765,411,458,869,104,자기계발,온라인강의,영상 교재,주3-4회,6,알고 있음,17
112,M,1976,3,264,287,551,310,334,644,354,378,732,88,자기계발,오프라인강의,비즈니스 시뮬레이션(Role Play),주3-4회,6,알고 있음,7
113,F,1995,3,485,235,720,486,337,823,488,433,921,98,자기계발,오프라인강의,비즈니스 시뮬레이션(Role Play),매일(주 7회),9,알고 있음,18
114,M,1988,3,377,317,694,382,322,704,434,373,807,103,자기계발,온라인강의,영상 교재,주3-4회,6,알고 있음,5
115,F,1992,3,318,303,621,325,305,630,340,309,649,19,승진,온라인강의,뉴스/이슈 기반 교재,주5-6회,7,알고 있음,14
116,M,1981,3,281,389,670,323,431,754,357,465,822,68,승진,오프라인강의,비즈니스 시뮬레이션(Role Play),주5-6회,6,알고 있음,11
117,F,1994,3,437,307,744,438,374,812,450,475,925,113,자기계발,온라인강의,영상 교재,매일(주 7회),8,알고 있음,20
118,M,1986,3,255,193,448,279,217,496,280,294,574,78,자기계발,오프라인강의,비즈니스 시뮬레이션(Role Play),주1-2회,2,알고 있음,2
119,F,1997,3,329,338,667,358,367,725,388,397,785,60,자기계발,참고서,일반적인 영어 텍스트 기반 교재,매일(주 7회),9,알고 있음,17
120,M,1996,3,347,310,657,399,316,715,424,341,765,50,자기계발,참고서,일반적인 영어 텍스트 기반 교재,주3-4회,4,알고 있음,6
121,F,1996,3,409,281,690,410,393,803,454,437,891,88,자기계발,오프라인강의,비즈니스 시뮬레이션(Role Play),주3-4회,5,알고 있음,7
122,M,1986,3,278,156,434,295,187,482,295,237,532,50,자기계발,참고서,일반적인 영어 텍스트 기반 교재,주3-4회,6,알고 있음,11
123,F,1992,3,293,429,722,330,466,796,432,467,899,103,자기계발,온라인강의,영상 교재,주3-4회,3,알고 있음,7
124,M,1983,3,159,262,421,189,292,481,253,293,546,65,승진,온라인강의,뉴스/이슈 기반 교재,주3-4회,5,알고 있음,10
125,F,1998,3,486,271,757,487,339,826,490,429,919,93,자기계발,오프라인강의,영상 교재,주1-2회,1,알고 있음,4
126,M,1992,3,458,233,691,459,327,786,463,391,854,68,승진,오프라인강의,비즈니스 시뮬레이션(Role Play),매일(주 7회),9,알고 있음,16
127,F,1993,3,293,276,569,315,315,630,315,321,636,6,자기계발,온라인강의,영상 교재,주3-4회,2,알고 있음,7
128,M,1993,3,341,239,580,373,271,644,466,364,830,186,취업,온라인강의,영상 교재,주5-6회,6,알고 있음,14
129,F,1990,3,452,310,762,453,367,820,456,457,913,93,자기계발,오프라인강의,영상 교재,주1-2회,1,알고 있음,3
130,M,1985,3,305,310,615,352,331,683,394,398,792,109,승진,온라인강의,영상 교재,매일(주 7회),10,알고 있음,16
131,F,2004,3,257,265,522,272,280,552,310,335,645,93,자기계발,온라인강의,뉴스/이슈 기반 교재,주1-2회,1,알고 있음,3
132,M,1983,3,329,407,736,361,447,808,398,470,868,60,승진,온라인강의,뉴스/이슈 기반 교재,주5-6회,7,알고 있음,15
133,F,1992,3,331,258,589,361,288,649,398,325,723,74,승진,오프라인강의,영상 교재,주3-4회,4,알고 있음,12
134,M,1995,3,317,252,569,356,291,647,379,319,698,51,자기계발,온라인강의,일반적인 영어 텍스트 기반 교재,주5-6회,6,알고 있음,14
135,F,1988,3,319,298,617,356,335,691,402,381,783,92,자기계발,오프라인강의,영상 교재,주1-2회,1,알고 있음,3
136,M,1996,3,305,451,756,344,452,796,411,472,883,87,자기계발,온라인강의,뉴스/이슈 기반 교재,주3-4회,5,알고 있음,6
137,F,1982,3,269,251,520,295,278,573,326,316,642,69,자기계발,온라인강의,영상 교재,주3-4회,3,알고 있음,6
138,M,2004,3,332,254,586,364,285,649,396,317,713,64,자기계발,온라인강의,뉴스/이슈 기반 교재,주3-4회,3,알고 있음,7
139,F,1997,3,272,239,511,273,268,541,295,297,592,51,취업,오프라인강의,영상 교재,주5-6회,6,알고 있음,16
140,M,2001,3,278,295,573,321,331,652,331,368,699,47,자기계발,온라인강의,뉴스/이슈 기반 교재,주5-6회,9,알고 있지 않음,15
141,F,1992,3,344,393,737,395,395,790,395,395,790,0,자기계발,참고서,일반적인 영어 텍스트 기반 교재,주1-2회,1,알고 있음,4
142,M,1993,3,262,273,535,295,295,590,295,295,590,0,승진,오프라인강의,비즈니스 시뮬레이션(Role Play),매일(주 7회),8,알고 있음,20
143,F,1984,3,381,306,687,408,333,741,447,372,819,78,자기계발,온라인강의,뉴스/이슈 기반 교재,주3-4회,4,알고 있음,8
144,M,1993,3,386,439,825,438,491,929,494,493,987,58,승진,오프라인강의,비즈니스 시뮬레이션(Role Play),주3-4회,4,알고 있음,14
145,F,1992,3,260,486,746,317,487,804,376,489,865,61,자기계발,참고서,일반적인 영어 텍스트 기반 교재,매일(주 7회),8,알고 있음,17
146,M,1980,3,457,364,821,465,414,879,493,464,957,78,자기계발,오프라인강의,비즈니스 시뮬레이션(Role Play),주1-2회,1,알고 있음,4
147,F,2004,3,273,441,714,292,442,734,352,446,798,64,자기계발,참고서,뉴스/이슈 기반 교재,주3-4회,7,알고 있음,15
148,M,1993,3,262,273,535,295,295,590,295,295,590,0,자기계발,온라인강의,뉴스/이슈 기반 교재,주3-4회,5,알고 있음,11
149,F,1991,3,320,417,737,357,454,811,377,474,851,40,자기계발,참고서,일반적인 영어 텍스트 기반 교재,주1-2회,1,알고 있음,4
150,M,2004,3,403,300,703,444,342,786,476,374,850,64,자기계발,오프라인강의,뉴스/이슈 기반 교재,주3-4회,2,알고 있음,5
151,F,2004,3,275,388,663,311,424,735,348,461,809,74,자기계발,온라인강의,뉴스/이슈 기반 교재,주5-6회,6,알고 있지 않음,15
152,M,1982,3,367,328,695,368,387,755,395,395,790,35,승진,오프라인강의,영상 교재,주3-4회,4,알고 있음,8
153,F,1983,3,361,442,803,400,481,881,471,492,963,82,승진,오프라인강의,영상 교재,주5-6회,7,알고 있음,13
154,M,2000,3,289,163,452,290,235,525,292,263,555,30,자기계발,참고서,일반적인 영어 텍스트 기반 교재,매일(주 7회),9,알고 있음,18
155,F,1990,3,284,393,677,299,408,707,338,447,785,78,자기계발,오프라인강의,비즈니스 시뮬레이션(Role Play),주1-2회,2,알고 있음,3
156,M,1999,3,339,310,649,357,337,694,411,381,792,98,승진,온라인강의,영상 교재,매일(주 7회),10,알고 있음,20
157,F,2005,3,289,285,574,321,317,638,357,353,710,72,자기계발,온라인강의,영상 교재,주3-4회,3,알고 있음,6
158,M,1999,3,464,234,698,467,334,801,475,395,870,69,승진,오프라인강의,비즈니스 시뮬레이션(Role Play),매일(주 7회),8,알고 있지 않음,19
159,F,1981,3,335,260,595,386,311,697,401,326,727,30,승진,참고서,일반적인 영어 텍스트 기반 교재,주5-6회,6,알고 있음,10
160,M,1986,3,210,241,451,230,261,491,280,284,564,73,승진,온라인강의,영상 교재,주3-4회,2,알고 있음,4
161,F,2002,3,308,253,561,355,300,655,384,329,713,58,승진,온라인강의,비즈니스 시뮬레이션(Role Play),주3-4회,6,알고 있음,11
162,M,1994,3,272,380,652,277,385,662,361,468,829,167,취업,온라인강의,뉴스/이슈 기반 교재,주3-4회,4,알고 있음,6
163,F,1989,3,314,323,637,334,343,677,381,390,771,94,자기계발,오프라인강의,뉴스/이슈 기반 교재,주3-4회,3,알고 있음,6
164,M,1988,3,268,270,538,309,311,620,348,350,698,78,자기계발,오프라인강의,비즈니스 시뮬레이션(Role Play),주1-2회,1,알고 있음,2
165,F,1996,3,254,340,594,269,355,624,316,402,718,94,자기계발,온라인강의,뉴스/이슈 기반 교재,주3-4회,5,알고 있지 않음,14
166,M,2007,3,310,409,719,342,441,783,357,456,813,30,자기계발,참고서,일반적인 영어 텍스트 기반 교재,매일(주 7회),9,알고 있음,11
167,F,1998,3,278,367,645,348,391,739,393,394,787,48,승진,오프라인강의,비즈니스 시뮬레이션(Role Play),주1-2회,2,알고 있음,4
168,M,1985,3,276,271,547,291,286,577,338,333,671,94,자기계발,온라인강의,뉴스/이슈 기반 교재,주3-4회,4,알고 있음,6
169,F,1989,3,280,441,721,319,442,761,391,444,835,74,승진,온라인강의,영상 교재,주3-4회,3,알고 있지 않음,8
170,M,1997,3,222,240,462,295,295,590,295,295,590,0,승진,오프라인강의,비즈니스 시뮬레이션(Role Play),주3-4회,4,알고 있음,8
171,F,1991,3,342,404,746,394,456,850,423,485,908,58,승진,오프라인강의,비즈니스 시뮬레이션(Role Play),주3-4회,4,알고 있음,8
172,M,1991,3,352,323,675,382,353,735,419,390,809,74,승진,참고서,뉴스/이슈 기반 교재,주5-6회,7,알고 있음,13
173,F,2005,3,291,374,665,301,384,685,363,386,749,64,자기계발,참고서,뉴스/이슈 기반 교재,주3-4회,5,알고 있음,10
174,M,1990,3,286,398,684,306,442,748,343,478,821,73,승진,온라인강의,영상 교재,주3-4회,2,알고 있음,3
175,F,1983,3,314,382,696,346,414,760,351,419,770,10,승진,오프라인강의,일반적인 영어 텍스트 기반 교재,주1-2회,2,알고 있음,3
176,M,1977,3,410,239,649,462,291,753,463,320,783,30,승진,참고서,일반적인 영어 텍스트 기반 교재,주5-6회,6,알고 있음,16
177,F,1980,3,321,309,630,336,324,660,383,371,754,94,자기계발,오프라인강의,뉴스/이슈 기반 교재,주3-4회,4,알고 있음,12
178,M,1995,3,300,431,731,337,468,805,470,469,939,134,취업,참고서,일반적인 영어 텍스트 기반 교재,주5-6회,7,알고 있음,11
179,F,1993,3,299,346,645,351,397,748,408,453,861,113,자기계발,온라인강의,영상 교재,주5-6회,6,알고 있음,12
180,M,1983,3,344,379,723,359,394,753,403,438,841,88,자기계발,온라인강의,비즈니스 시뮬레이션(Role Play),주3-4회,3,알고 있음,7
181,F,1985,3,326,344,670,355,373,728,380,398,778,50,자기계발,오프라인강의,일반적인 영어 텍스트 기반 교재,주3-4회,3,알고 있음,10
182,M,1994,3,311,281,592,360,330,690,411,382,793,103,자기계발,온라인강의,영상 교재,주3-4회,6,알고 있지 않음,11
183,F,2004,3,286,243,529,327,285,612,332,290,622,10,자기계발,오프라인강의,일반적인 영어 텍스트 기반 교재,주1-2회,1,알고 있음,5
184,M,1987,3,216,156,372,265,205,470,280,220,500,30,승진,참고서,일반적인 영어 텍스트 기반 교재,주5-6회,6,알고 있음,9
185,F,1986,3,449,297,746,450,344,794,494,388,882,88,자기계발,오프라인강의,비즈니스 시뮬레이션(Role Play),주3-4회,4,알고 있음,5
186,M,2007,3,439,306,745,444,311,755,476,343,819,64,자기계발,온라인강의,뉴스/이슈 기반 교재,주3-4회,3,알고 있음,7
187,F,1986,3,483,246,729,484,319,803,486,415,901,98,자기계발,온라인강의,비즈니스 시뮬레이션(Role Play),주5-6회,9,알고 있음,14
188,M,1993,3,302,368,670,306,370,676,310,372,682,6,자기계발,오프라인강의,일반적인 영어 텍스트 기반 교재,주3-4회,3,알고 있지 않음,7
189,F,1993,3,113,279,392,269,280,549,295,295,590,41,승진,오프라인강의,비즈니스 시뮬레이션(Role Play),주3-4회,6,알고 있음,6
190,M,1998,3,252,300,552,327,304,631,342,319,661,30,승진,참고서,일반적인 영어 텍스트 기반 교재,매일(주 7회),9,알고 있음,18
191,F,2004,3,264,453,717,366,454,820,438,456,894,74,승진,온라인강의,뉴스/이슈 기반 교재,매일(주 7회),10,알고 있음,15
192,M,1982,3,473,377,850,475,384,859,476,431,907,48,승진,오프라인강의,비즈니스 시뮬레이션(Role Play),주1-2회,2,알고 있음,3
193,F,2005,3,398,301,699,446,367,813,476,470,946,133,취업,오프라인강의,일반적인 영어 텍스트 기반 교재,주5-6회,6,알고 있음,16
194,M,1980,3,302,362,664,359,418,777,388,447,835,58,승진,온라인강의,비즈니스 시뮬레이션(Role Play),주3-4회,3,알고 있음,6
195,F,2002,3,405,408,813,409,411,820,412,417,829,9,자기계발,참고서,일반적인 영어 텍스트 기반 교재,주1-2회,1,알고 있지 않음,4
196,M,1999,3,466,229,695,467,323,790,473,483,956,166,취업,오프라인강의,영상 교재,주1-2회,2,알고 있음,4
197,F,2007,3,269,322,591,271,325,596,308,362,670,74,자기계발,오프라인강의,뉴스/이슈 기반 교재,주5-6회,7,알고 있음,13
198,M,1986,3,310,420,730,334,444,778,388,494,882,104,자기계발,온라인강의,뉴스/이슈 기반 교재,주5-6회,6,알고 있음,12
199,F,1999,3,327,289,616,330,293,623,334,313,647,24,자기계발,참고서,일반적인 영어 텍스트 기반 교재,주1-2회,2,알고 있음,3
200,M,1981,3,262,219,481,277,234,511,295,295,590,79,자기계발,오프라인강의,뉴스/이슈 기반 교재,주5-6회,7,알고 있음,13
201,F,1990,3,308,424,732,328,443,771,409,445,854,83,승진,오프라인강의,영상 교재,매일(주 7회),9,알고 있음,16
202,M,2007,3,426,454,880,431,459,890,440,471,911,21,자기계발,참고서,일반적인 영어 텍스트 기반 교재,주3-4회,4,알고 있음,9
203,F,1992,3,490,445,935,491,450,941,492,489,981,40,자기계발,참고서,일반적인 영어 텍스트 기반 교재,주1-2회,1,알고 있음,2
204,M,2000,3,150,245,395,157,248,405,162,253,415,10,승진,참고서,일반적인 영어 텍스트 기반 교재,주1-2회,2,알고 있음,3
205,F,1997,3,419,383,802,434,398,832,466,430,896,64,자기계발,온라인강의,뉴스/이슈 기반 교재,주3-4회,3,알고 있음,5
206,M,2003,3,401,423,824,407,428,835,418,437,855,20,자기계발,참고서,일반적인 영어 텍스트 기반 교재,주3-4회,4,알고 있음,7
207,F,1982,3,265,323,588,272,326,598,306,360,666,68,승진,오프라인강의,비즈니스 시뮬레이션(Role Play),매일(주 7회),10,알고 있음,16
208,M,1990,3,231,264,495,282,294,576,295,295,590,14,자기계발,오프라인강의,비즈니스 시뮬레이션(Role Play),주1-2회,2,알고 있음,3
209,F,1989,3,312,423,735,337,448,785,371,482,853,68,승진,오프라인강의,비즈니스 시뮬레이션(Role Play),매일(주 7회),8,알고 있음,17
210,M,1998,3,169,196,365,216,243,459,277,294,571,112,자기계발,온라인강의,영상 교재,주5-6회,9,알고 있음,10
211,F,1983,3,375,332,707,431,389,820,455,413,868,48,자기계발,온라인강의,비즈니스 시뮬레이션(Role Play),주1-2회,1,알고 있음,4
212,M,2003,3,292,141,433,293,223,516,294,294,588,72,자기계발,오프라인강의,뉴스/이슈 기반 교재,주5-6회,7,알고 있음,14
213,F,1980,3,332,454,786,396,458,854,426,468,894,40,자기계발,온라인강의,일반적인 영어 텍스트 기반 교재,주1-2회,2,알고 있음,2
214,M,2002,3,242,256,498,279,293,572,295,295,590,18,자기계발,오프라인강의,영상 교재,주3-4회,4,알고 있음,8
215,F,1981,3,229,242,471,234,247,481,271,284,555,74,승진,오프라인강의,뉴스/이슈 기반 교재,주5-6회,5,알고 있음,10
216,M,2006,3,309,383,692,336,410,746,345,421,766,20,자기계발,오프라인강의,일반적인 영어 텍스트 기반 교재,주3-4회,4,알고 있음,7
217,F,1987,3,334,315,649,339,360,699,411,423,834,135,자기계발,온라인강의,뉴스/이슈 기반 교재,주5-6회,8,알고 있음,5
218,M,2003,3,333,408,741,338,413,751,370,445,815,64,자기계발,오프라인강의,뉴스/이슈 기반 교재,주3-4회,5,알고 있음,6
219,F,1999,3,423,338,761,426,344,770,453,371,824,54,자기계발,오프라인강의,뉴스/이슈 기반 교재,주1-2회,2,알고 있음,3
220,M,1986,3,272,190,462,275,198,473,276,281,557,84,승진,온라인강의,영상 교재,주5-6회,6,알고 있음,8
221,F,1987,3,398,406,804,430,438,868,460,468,928,60,자기계발,참고서,일반적인 영어 텍스트 기반 교재,주5-6회,7,알고 있음,12
222,M,1983,3,247,127,374,248,135,383,250,203,453,70,승진,오프라인강의,비즈니스 시뮬레이션(Role Play),매일(주 7회),10,알고 있음,15
223,F,1992,3,490,425,915,495,434,934,495,449,964,30,자기계발,참고서,일반적인 영어 텍스트 기반 교재,주5-6회,8,알고 있음,9
224,M,2005,3,348,444,792,420,446,866,473,476,949,83,자기계발,온라인강의,영상 교재,매일(주 7회),9,알고 있음,18
225,F,1989,3,321,287,608,325,291,616,350,316,666,50,자기계발,참고서,일반적인 영어 텍스트 기반 교재,주3-4회,3,알고 있음,6
226,M,2003,3,138,221,359,221,222,443,226,227,453,10,자기계발,참고서,일반적인 영어 텍스트 기반 교재,주1-2회,2,알고 있음,3
227,M,1983,3,304,438,742,397,439,836,431,473,904,68,승진,오프라인강의,비즈니스 시뮬레이션(Role Play),매일(주 7회),10,알고 있음,16
228,F,2001,3,228,239,467,232,245,477,269,282,551,74,자기계발,온라인강의,뉴스/이슈 기반 교재,매일(주 7회),9,알고 있음,12
229,M,2001,3,348,424,772,373,449,822,469,451,920,98,자기계발,오프라인강의,비즈니스 시뮬레이션(Role Play),매일(주 7회),7,알고 있음,18
230,F,2007,3,348,283,631,353,288,641,385,320,705,64,자기계발,온라인강의,뉴스/이슈 기반 교재,주3-4회,3,알고 있음,6
231,F,1997,3,335,325,660,339,331,670,344,335,679,9,승진,오프라인강의,비즈니스 시뮬레이션(Role Play),주1-2회,2,알고 있지 않음,3
232,M,2006,3,241,173,414,242,202,444,279,239,518,74,자기계발,오프라인강의,뉴스/이슈 기반 교재,매일(주 7회),10,알고 있음,17
233,F,1988,3,347,471,818,424,472,896,484,486,970,74,승진,오프라인강의,뉴스/이슈 기반 교재,주5-6회,6,알고 있음,9
234,M,1987,3,449,445,894,483,479,962,495,495,990,28,자기계발,온라인강의,일반적인 영어 텍스트 기반 교재,주1-2회,1,알고 있음,5
235,F,1981,3,160,271,431,162,273,435,225,274,499,64,승진,온라인강의,뉴스/이슈 기반 교재,주3-4회,3,알고 있음,6
236,M,2002,3,432,458,890,437,460,897,487,493,980,83,자기계발,오프라인강의,영상 교재,주5-6회,8,알고 있음,8
237,F,1985,3,275,332,607,324,381,705,386,382,768,63,승진,오프라인강의,영상 교재,주1-2회,1,알고 있음,3
238,M,1983,3,277,323,600,279,327,606,285,332,617,11,자기계발,오프라인강의,영상 교재,주1-2회,2,알고 있지 않음,2
239,F,2003,3,215,141,356,216,214,430,248,246,494,64,자기계발,온라인강의,뉴스/이슈 기반 교재,주3-4회,3,알고 있음,8
240,M,1996,3,207,160,367,212,166,378,244,198,442,64,승진,온라인강의,뉴스/이슈 기반 교재,주3-4회,5,알고 있음,4
241,F,1986,3,189,190,379,251,249,500,298,281,579,79,자기계발,참고서,일반적인 영어 텍스트 기반 교재,주1-2회,1,알고 있음,4
242,M,1990,3,286,145,431,287,153,440,289,216,505,65,승진,온라인강의,뉴스/이슈 기반 교재,주3-4회,3,알고 있음,6
243,F,1984,3,293,220,513,294,226,520,295,295,590,70,승진,온라인강의,영상 교재,매일(주 7회),7,알고 있음,18
244,M,1999,3,283,236,519,295,295,590,330,342,672,82,승진,온라인강의,일반적인 영어 텍스트 기반 교재,매일(주 7회),9,알고 있음,16
245,F,2001,3,199,246,445,207,248,455,267,252,519,64,자기계발,온라인강의,뉴스/이슈 기반 교재,주3-4회,3,알고 있음,8
246,M,1997,3,221,290,511,226,294,520,231,299,530,10,자기계발,참고서,일반적인 영어 텍스트 기반 교재,주1-2회,1,알고 있음,3
247,F,2005,3,327,433,760,347,434,781,417,437,854,73,자기계발,온라인강의,영상 교재,주3-4회,3,알고 있음,5
248,M,1980,3,341,322,663,345,327,672,394,376,770,98,자기계발,온라인강의,비즈니스 시뮬레이션(Role Play),주5-6회,8,알고 있음,12
249,F,1982,3,451,490,941,495,495,990,495,495,990,0,자기계발,참고서,뉴스/이슈 기반 교재,주5-6회,5,알고 있음,12
250,M,2006,3,302,463,765,365,464,829,370,471,841,12,자기계발,참고서,일반적인 영어 텍스트 기반 교재,주1-2회,1,알고 있음,4
251,F,1981,3,319,356,675,327,359,686,379,410,789,103,자기계발,온라인강의,영상 교재,주3-4회,4,알고 있음,17
252,M,1986,3,157,259,416,161,263,424,208,264,472,48,승진,오프라인강의,비즈니스 시뮬레이션(Role Play),주1-2회,1,알고 있음,4
253,F,1990,3,276,224,500,295,295,590,295,295,590,0,승진,오프라인강의,비즈니스 시뮬레이션(Role Play),주1-2회,2,알고 있음,3
254,M,1996,3,301,313,614,308,317,625,313,325,638,13,자기계발,온라인강의,비즈니스 시뮬레이션(Role Play),주5-6회,5,알고 있지 않음,15
255,F,2001,3,378,360,738,409,392,801,424,407,831,30,자기계발,참고서,일반적인 영어 텍스트 기반 교재,매일(주 7회),10,알고 있음,14
256,M,2004,3,257,186,443,258,259,517,285,286,571,54,자기계발,오프라인강의,뉴스/이슈 기반 교재,주1-2회,4,알고 있음,1
257,F,1995,3,268,199,467,269,259,528,295,295,590,62,자기계발,온라인강의,뉴스/이슈 기반 교재,주3-4회,3,알고 있음,7
258,M,1991,3,200,187,387,225,212,437,261,248,509,72,승진,오프라인강의,영상 교재,주3-4회,4,알고 있음,7
259,F,1989,3,319,427,746,386,428,814,438,480,918,104,자기계발,참고서,뉴스/이슈 기반 교재,주5-6회,8,알고 있음,12
260,M,1994,3,143,291,434,151,292,443,218,293,511,68,승진,오프라인강의,비즈니스 시뮬레이션(Role Play),주5-6회,5,알고 있음,10
261,F,1982,3,346,353,699,373,372,745,415,413,828,83,승진,온라인강의,영상 교재,매일(주 7회),8,알고 있음,20
262,M,1998,3,116,257,373,125,258,383,175,262,437,54,자기계발,온라인강의,뉴스/이슈 기반 교재,주1-2회,2,알고 있음,3
263,F,1988,3,198,226,424,250,278,528,293,293,586,58,승진,오프라인강의,비즈니스 시뮬레이션(Role Play),주3-4회,3,알고 있음,9
264,M,1995,3,246,252,498,276,282,558,295,295,590,32,자기계발,온라인강의,뉴스/이슈 기반 교재,주1-2회,1,알고 있음,2
265,F,2003,3,290,168,458,291,232,523,292,262,554,31,자기계발,참고서,일반적인 영어 텍스트 기반 교재,매일(주 7회),9,알고 있음,18
266,M,1989,3,335,323,658,374,362,736,385,372,757,21,자기계발,참고서,일반적인 영어 텍스트 기반 교재,주3-4회,4,알고 있음,9
267,F,2001,3,321,475,796,405,476,881,486,493,979,98,자기계발,온라인강의,비즈니스 시뮬레이션(Role Play),주5-6회,6,알고 있음,13
268,M,1988,3,432,350,782,433,407,840,489,464,953,113,자기계발,온라인강의,영상 교재,매일(주 7회),7,알고 있음,17
269,F,1991,3,487,433,920,489,438,927,495,495,990,63,자기계발,오프라인강의,영상 교재,주5-6회,6,알고 있음,12
270,M,1992,3,250,216,466,251,222,473,275,246,521,48,승진,오프라인강의,비즈니스 시뮬레이션(Role Play),주1-2회,2,알고 있음,3
271,F,2006,3,222,379,601,231,380,611,294,382,676,65,자기계발,온라인강의,영상 교재,주1-2회,1,알고 있음,4
272,M,1998,3,303,324,627,345,351,696,387,407,794,98,승진,오프라인강의,영상 교재,주5-6회,5,알고 있음,8
273,F,2003,3,210,343,553,218,345,563,301,346,647,84,자기계발,온라인강의,영상 교재,매일(주 7회),10,알고 있음,13
274,M,2001,3,315,235,550,319,242,561,334,257,591,30,자기계발,참고서,일반적인 영어 텍스트 기반 교재,주5-6회,7,알고 있음,11
275,F,1982,3,433,432,865,435,437,872,487,488,975,103,자기계발,온라인강의,영상 교재,주3-4회,5,알고 있음,6
276,M,2003,3,254,184,438,255,258,513,292,294,586,73,자기계발,오프라인강의,영상 교재,주3-4회,3,알고 있음,8
277,F,1987,3,355,325,680,385,355,740,409,379,788,48,승진,오프라인강의,비즈니스 시뮬레이션(Role Play),주1-2회,2,알고 있음,3
278,M,1990,3,405,337,742,408,345,753,414,405,819,66,승진,오프라인강의,비즈니스 시뮬레이션(Role Play),매일(주 7회),10,알고 있음,14
279,F,2001,3,311,352,663,374,416,790,385,418,803,13,자기계발,참고서,일반적인 영어 텍스트 기반 교재,주3-4회,4,알고 있음,6
280,M,1997,3,249,160,409,249,224,473,295,295,590,117,취업,온라인강의,영상 교재,매일(주 7회),9,알고 있음,18
281,F,1992,3,466,416,882,471,423,894,475,429,904,10,자기계발,참고서,일반적인 영어 텍스트 기반 교재,주1-2회,1,알고 있지 않음,4
282,M,2006,3,145,259,404,151,262,413,176,267,443,30,자기계발,오프라인강의,일반적인 영어 텍스트 기반 교재,주5-6회,6,알고 있음,12
283,F,1984,3,332,353,685,339,356,695,364,381,745,50,자기계발,참고서,일반적인 영어 텍스트 기반 교재,주3-4회,3,알고 있음,7
284,M,1985,3,189,236,425,196,239,435,211,244,455,20,승진,참고서,일반적인 영어 텍스트 기반 교재,주3-4회,3,알고 있음,8
285,F,1998,3,227,241,468,251,265,516,276,290,566,50,자기계발,참고서,일반적인 영어 텍스트 기반 교재,주3-4회,5,알고 있음,8
286,M,1994,3,240,191,431,274,225,499,279,260,539,40,자기계발,참고서,일반적인 영어 텍스트 기반 교재,주1-2회,2,알고 있음,3
287,F,1998,3,354,358,712,395,399,794,478,482,960,166,취업,온라인강의,뉴스/이슈 기반 교재,주3-4회,5,알고 있음,7
288,M,1989,3,147,235,382,247,248,495,276,277,553,58,승진,오프라인강의,비즈니스 시뮬레이션(Role Play),주3-4회,3,알고 있음,9
289,F,1989,3,269,383,652,274,386,660,333,387,720,60,자기계발,온라인강의,일반적인 영어 텍스트 기반 교재,매일(주 7회),10,알고 있음,12
290,M,2007,3,428,339,767,431,346,777,432,428,860,83,자기계발,오프라인강의,영상 교재,주5-6회,7,알고 있음,11
291,F,1998,3,479,379,858,480,432,912,495,495,990,78,자기계발,온라인강의,영상 교재,주5-6회,5,알고 있음,13
292,M,1987,3,324,491,815,330,492,822,377,493,870,48,자기계발,오프라인강의,비즈니스 시뮬레이션(Role Play),주1-2회,2,알고 있음,5
293,F,1989,3,187,248,435,234,249,483,264,279,543,60,자기계발,참고서,일반적인 영어 텍스트 기반 교재,주5-6회,5,알고 있음,9
294,M,1983,3,278,269,547,281,275,556,286,282,568,12,자기계발,오프라인강의,뉴스/이슈 기반 교재,주3-4회,5,알고 있지 않음,10
295,F,1984,3,335,333,668,365,363,728,399,397,796,68,승진,오프라인강의,비즈니스 시뮬레이션(Role Play),매일(주 7회),9,알고 있음,14
296,M,1999,3,312,338,650,395,421,816,419,445,864,48,승진,온라인강의,비즈니스 시뮬레이션(Role Play),주1-2회,1,알고 있음,4
297,F,1984,3,202,340,542,208,345,553,217,351,568,15,자기계발,오프라인강의,영상 교재,주1-2회,2,알고 있지 않음,5
298,M,1983,3,439,441,880,469,471,940,495,495,990,50,승진,오프라인강의,영상 교재,주5-6회,8,알고 있음,13
299,F,1978,3,163,159,322,200,195,395,232,226,458,63,자기계발,온라인강의,뉴스/이슈 기반 교재,주3-4회,4,알고 있음,8
300,M,1991,3,353,337,690,356,342,698,393,379,772,74,자기계발,온라인강의,뉴스/이슈 기반 교재,주5-6회,7,알고 있음,12
301,F,1982,3,222,280,502,267,285,552,324,362,686,134,자기계발,온라인강의,뉴스/이슈 기반 교재,주1-2회,2,알고 있음,3
302,M,1989,3,213,198,411,217,203,420,231,225,456,36,자기계발,참고서,일반적인 영어 텍스트 기반 교재,매일(주 7회),8,알고 있지 않음,14
303,F,1991,3,273,264,537,291,289,580,343,364,707,127,자기계발,오프라인강의,영상 교재,주1-2회,2,알고 있음,4
304,M,1995,3,218,156,374,274,273,547,295,285,580,33,승진,온라인강의,뉴스/이슈 기반 교재,주3-4회,3,알고 있음,10
305,F,1974,3,330,332,662,360,362,722,401,403,804,82,승진,참고서,영상 교재,매일(주 7회),10,알고 있음,18
306,M,1989,3,295,223,518,295,232,527,295,295,590,63,자기계발,온라인강의,비즈니스 시뮬레이션(Role Play),주5-6회,5,알고 있음,11
307,F,2005,3,262,218,480,265,227,492,266,280,546,54,자기계발,오프라인강의,뉴스/이슈 기반 교재,주1-2회,1,알고 있음,4
308,M,1991,3,181,164,345,213,198,411,286,262,548,137,자기계발,오프라인강의,비즈니스 시뮬레이션(Role Play),주5-6회,6,알고 있음,10
309,F,1987,3,178,169,347,198,199,397,252,241,493,96,승진,오프라인강의,영상 교재,주5-6회,8,알고 있음,12
310,M,1990,3,205,179,384,209,187,396,239,217,456,60,자기계발,참고서,일반적인 영어 텍스트 기반 교재,매일(주 7회),9,알고 있음,20
311,F,1994,3,262,142,404,265,148,413,269,156,425,12,승진,온라인강의,비즈니스 시뮬레이션(Role Play),매일(주 7회),8,알고 있지 않음,16
312,M,2001,3,273,368,641,280,371,651,354,372,726,75,자기계발,온라인강의,뉴스/이슈 기반 교재,주5-6회,6,알고 있음,12
313,F,1995,3,125,254,379,130,257,387,198,258,456,69,승진,오프라인강의,비즈니스 시뮬레이션(Role Play),매일(주 7회),9,알고 있음,17
314,M,1982,3,129,292,421,136,293,429,141,294,435,6,자기계발,온라인강의,영상 교재,주1-2회,2,알고 있지 않음,3
315,F,1985,3,249,170,419,269,190,459,272,250,522,63,자기계발,온라인강의,영상 교재,주1-2회,2,알고 있음,3
316,M,1997,3,224,265,489,279,293,572,295,295,590,18,자기계발,온라인강의,일반적인 영어 텍스트 기반 교재,주3-4회,3,알고 있음,8
317,F,2007,3,267,308,575,309,349,658,346,386,732,74,자기계발,참고서,뉴스/이슈 기반 교재,주5-6회,7,알고 있음,16
318,M,2002,3,138,327,465,331,400,731,372,441,813,82,자기계발,오프라인강의,영상 교재,주5-6회,6,알고 있음,10
319,F,1988,3,236,172,408,238,180,418,287,229,516,98,자기계발,오프라인강의,비즈니스 시뮬레이션(Role Play),주5-6회,8,알고 있음,12
320,M,1979,3,397,488,885,480,489,969,495,495,990,21,자기계발,오프라인강의,비즈니스 시뮬레이션(Role Play),주3-4회,3,알고 있음,7
321,F,1998,3,491,407,898,492,415,907,493,445,938,31,자기계발,온라인강의,일반적인 영어 텍스트 기반 교재,주5-6회,6,알고 있음,11
322,M,1988,3,399,351,750,414,366,780,434,396,830,50,자기계발,참고서,일반적인 영어 텍스트 기반 교재,매일(주 7회),9,알고 있음,17
323,F,2001,3,431,393,824,434,398,832,439,403,842,10,자기계발,참고서,일반적인 영어 텍스트 기반 교재,주1-2회,2,알고 있음,3
324,M,1995,3,478,365,843,481,372,853,482,429,911,58,승진,온라인강의,비즈니스 시뮬레이션(Role Play),주3-4회,6,알고 있음,10
325,F,1994,3,315,490,805,324,491,815,391,492,883,68,승진,오프라인강의,비즈니스 시뮬레이션(Role Play),매일(주 7회),9,알고 있음,16
326,M,1982,3,252,255,507,257,259,516,261,264,525,9,자기계발,온라인강의,뉴스/이슈 기반 교재,주3-4회,3,알고 있지 않음,8
327,F,2005,3,355,427,782,360,432,792,443,433,876,84,자기계발,오프라인강의,영상 교재,매일(주 7회),7,알고 있음,14
328,M,1994,3,458,380,838,458,472,930,460,475,935,5,승진,오프라인강의,비즈니스 시뮬레이션(Role Play),매일(주 7회),9,알고 있음,17
329,F,1983,3,443,411,854,468,436,904,495,495,990,86,자기계발,오프라인강의,영상 교재,주1-2회,1,알고 있음,4
330,M,2002,3,297,305,602,300,305,605,314,335,649,44,자기계발,참고서,일반적인 영어 텍스트 기반 교재,주3-4회,5,알고 있음,8
331,F,1974,3,296,235,531,300,241,541,319,288,607,66,승진,오프라인강의,비즈니스 시뮬레이션(Role Play),주1-2회,2,알고 있음,3
332,M,2005,3,461,351,812,464,357,821,465,411,876,55,자기계발,온라인강의,뉴스/이슈 기반 교재,주1-2회,2,알고 있음,5
333,F,1997,3,248,219,467,256,234,490,295,292,587,97,자기계발,오프라인강의,뉴스/이슈 기반 교재,매일(주 7회),7,알고 있음,20
334,M,1990,3,298,278,576,312,301,613,321,315,636,23,자기계발,온라인강의,뉴스/이슈 기반 교재,주5-6회,8,알고 있음,11
335,F,1981,3,287,290,577,295,295,590,351,342,693,103,자기계발,참고서,뉴스/이슈 기반 교재,주3-4회,5,알고 있음,9
336,M,1988,3,326,363,689,356,393,749,439,476,915,166,승진,온라인강의,영상 교재,주5-6회,5,알고 있음,9
337,F,1989,3,271,288,559,288,289,577,295,295,590,13,자기계발,온라인강의,비즈니스 시뮬레이션(Role Play),매일(주 7회),10,알고 있음,18
338,M,1988,3,220,279,499,227,282,509,395,395,790,281,자기계발,오프라인강의,영상 교재,주5-6회,7,알고 있음,11
339,F,1986,3,242,241,483,247,246,493,289,287,576,83,승진,온라인강의,영상 교재,주5-6회,5,알고 있음,12
340,M,1986,3,183,185,368,227,229,456,273,276,549,93,자기계발,오프라인강의,영상 교재,주1-2회,2,알고 있음,5
341,F,1995,3,341,250,591,342,263,605,344,331,675,70,승진,온라인강의,비즈니스 시뮬레이션(Role Play),주5-6회,6,알고 있음,12
342,M,2004,3,405,341,746,406,346,752,408,429,837,85,자기계발,온라인강의,영상 교재,매일(주 7회),10,알고 있음,17
343,F,1988,3,105,295,400,209,295,504,267,295,562,58,승진,오프라인강의,비즈니스 시뮬레이션(Role Play),주3-4회,2,알고 있음,9
344,M,2003,3,233,261,494,283,285,568,295,295,590,22,자기계발,온라인강의,영상 교재,주1-2회,1,알고 있음,5
345,F,1985,3,250,254,504,274,278,552,295,295,590,38,자기계발,오프라인강의,영상 교재,매일(주 7회),9,알고 있음,16
346,M,2004,3,313,370,683,318,376,694,324,383,707,13,자기계발,참고서,뉴스/이슈 기반 교재,주1-2회,1,알고 있지 않음,5
347,F,1993,3,185,205,390,227,247,474,269,288,557,83,승진,오프라인강의,영상 교재,주5-6회,6,알고 있음,13
348,M,2000,3,343,354,697,377,388,765,434,444,878,113,자기계발,온라인강의,영상 교재,매일(주 7회),8,알고 있음,20
349,F,2003,3,278,214,492,279,220,499,284,225,509,10,자기계발,참고서,일반적인 영어 텍스트 기반 교재,주1-2회,2,알고 있음,5
350,M,1990,3,301,384,685,330,392,722,358,395,753,31,승진,오프라인강의,비즈니스 시뮬레이션(Role Play),주3-4회,6,알고 있음,10
351,F,2006,3,333,278,611,334,307,641,371,344,715,74,자기계발,온라인강의,뉴스/이슈 기반 교재,주5-6회,5,알고 있음,14
352,M,1982,3,249,241,490,290,282,572,295,295,590,18,자기계발,참고서,일반적인 영어 텍스트 기반 교재,주5-6회,5,알고 있음,12
353,F,2000,3,150,231,381,216,257,473,250,291,541,68,승진,오프라인강의,비즈니스 시뮬레이션(Role Play),주5-6회,7,알고 있음,15
354,M,2002,3,290,151,441,291,159,450,292,242,534,84,자기계발,온라인강의,영상 교재,매일(주 7회),9,알고 있음,16
355,F,2000,3,252,214,466,279,241,520,289,252,541,21,자기계발,오프라인강의,일반적인 영어 텍스트 기반 교재,주3-4회,5,알고 있음,8
356,M,1988,3,231,176,407,232,223,455,278,269,547,92,자기계발,온라인강의,영상 교재,주1-2회,2,알고 있음,3
357,F,1988,3,152,213,365,158,216,374,165,219,384,10,자기계발,참고서,일반적인 영어 텍스트 기반 교재,주1-2회,2,알고 있지 않음,5
358,M,1984,3,394,349,743,395,431,826,437,473,910,84,자기계발,온라인강의,뉴스/이슈 기반 교재,주1-2회,2,알고 있음,5
359,F,1979,3,291,267,558,321,297,618,360,336,696,78,자기계발,오프라인강의,비즈니스 시뮬레이션(Role Play),주1-2회,1,알고 있음,6
360,M,1989,3,336,401,737,345,403,748,439,405,844,96,자기계발,온라인강의,뉴스/이슈 기반 교재,주3-4회,4,알고 있음,5
361,F,1978,3,289,271,560,294,276,570,299,282,581,11,자기계발,참고서,일반적인 영어 텍스트 기반 교재,주1-2회,2,알고 있음,7
362,M,2003,3,370,255,625,371,263,634,373,346,719,85,자기계발,온라인강의,영상 교재,매일(주 7회),10,알고 있음,18
363,F,1988,3,368,343,711,420,395,815,454,429,883,68,승진,온라인강의,비즈니스 시뮬레이션(Role Play),주5-6회,8,알고 있음,14
364,M,1985,3,232,192,424,236,237,473,260,261,521,48,승진,오프라인강의,비즈니스 시뮬레이션(Role Play),주1-2회,2,알고 있음,4
365,F,1981,3,382,393,775,387,394,781,395,395,790,9,자기계발,오프라인강의,영상 교재,주5-6회,7,알고 있음,12
366,M,1993,3,279,322,601,286,323,609,393,382,775,166,취업,오프라인강의,영상 교재,주1-2회,1,알고 있음,6
367,F,2006,3,262,395,657,270,395,665,291,395,686,21,자기계발,참고서,일반적인 영어 텍스트 기반 교재,주3-4회,3,알고 있음,7
368,M,2000,3,394,306,700,395,312,707,395,366,761,54,자기계발,오프라인강의,뉴스/이슈 기반 교재,주1-2회,2,알고 있음,4
369,F,2001,3,232,381,613,240,382,622,267,385,652,30,자기계발,온라인강의,일반적인 영어 텍스트 기반 교재,매일(주 7회),10,알고 있음,19
370,M,2001,3,357,366,723,364,369,733,401,406,807,74,자기계발,온라인강의,뉴스/이슈 기반 교재,주5-6회,7,알고 있음,16
371,F,1995,3,219,217,436,256,237,493,295,273,568,75,승진,온라인강의,비즈니스 시뮬레이션(Role Play),주3-4회,3,알고 있음,9
372,M,1996,3,258,224,482,287,253,540,295,295,590,50,자기계발,온라인강의,영상 교재,매일(주 7회),10,알고 있음,19
373,F,2003,3,224,217,441,239,232,471,275,268,543,72,자기계발,온라인강의,영상 교재,주3-4회,3,알고 있음,4
374,M,1992,3,233,171,404,253,249,502,284,280,564,62,승진,오프라인강의,영상 교재,주1-2회,2,알고 있음,6
375,F,1993,3,254,246,500,295,295,590,295,295,590,0,승진,참고서,뉴스/이슈 기반 교재,주3-4회,3,알고 있음,8
376,M,2004,3,198,212,410,229,243,472,244,258,502,30,자기계발,참고서,일반적인 영어 텍스트 기반 교재,주5-6회,7,알고 있음,16
377,F,1988,3,278,235,513,280,241,521,335,318,653,132,승진,오프라인강의,비즈니스 시뮬레이션(Role Play),매일(주 7회),10,알고 있음,16
378,M,1999,3,315,419,734,324,420,744,381,422,803,59,승진,오프라인강의,비즈니스 시뮬레이션(Role Play),주3-4회,4,알고 있음,9
379,F,2002,3,315,339,654,330,354,684,371,395,766,82,자기계발,온라인강의,영상 교재,매일(주 7회),7,알고 있음,20
380,M,1981,3,182,281,463,190,282,472,215,287,502,30,승진,참고서,일반적인 영어 텍스트 기반 교재,주5-6회,5,알고 있음,14
381,F,1983,3,282,258,540,295,295,590,295,295,590,0,승진,온라인강의,비즈니스 시뮬레이션(Role Play),주5-6회,6,알고 있음,17
382,M,2007,3,284,331,615,357,341,698,372,356,728,30,자기계발,참고서,일반적인 영어 텍스트 기반 교재,매일(주 7회),10,알고 있음,16
383,F,1984,3,235,295,530,241,300,541,248,303,551,10,자기계발,참고서,뉴스/이슈 기반 교재,주5-6회,5,알고 있지 않음,10
384,M,1999,3,344,252,596,345,309,654,368,379,747,93,자기계발,온라인강의,영상 교재,주1-2회,2,알고 있음,3
385,F,1991,3,278,292,570,283,295,578,335,347,682,104,자기계발,오프라인강의,뉴스/이슈 기반 교재,매일(주 7회),10,알고 있음,13
386,M,1992,3,371,225,596,372,328,700,395,395,790,90,자기계발,온라인강의,비즈니스 시뮬레이션(Role Play),주5-6회,7,알고 있음,14
387,F,1981,3,329,349,678,366,386,752,413,433,846,94,자기계발,온라인강의,뉴스/이슈 기반 교재,주3-4회,3,알고 있음,9
388,M,1986,3,253,168,421,256,175,431,257,262,519,88,승진,오프라인강의,비즈니스 시뮬레이션(Role Play),주3-4회,4,알고 있음,9
389,F,1997,3,363,375,738,456,468,924,495,495,990,66,승진,오프라인강의,비즈니스 시뮬레이션(Role Play),주5-6회,8,알고 있음,5
390,M,2002,3,202,308,510,209,310,519,268,311,579,60,자기계발,참고서,일반적인 영어 텍스트 기반 교재,매일(주 7회),10,알고 있음,18
391,F,1994,3,411,351,762,412,408,820,437,433,870,50,자기계발,온라인강의,일반적인 영어 텍스트 기반 교재,주3-4회,3,알고 있음,4
392,M,2005,3,244,286,530,278,295,573,298,295,593,20,자기계발,참고서,뉴스/이슈 기반 교재,주5-6회,6,알고 있음,7
393,F,1979,3,312,400,712,371,401,772,405,435,840,68,승진,오프라인강의,비즈니스 시뮬레이션(Role Play),주5-6회,7,알고 있음,9
394,M,1992,3,287,232,519,289,239,528,295,295,590,62,자기계발,온라인강의,뉴스/이슈 기반 교재,주3-4회,6,알고 있음,8
395,F,1986,3,232,287,519,239,289,528,295,295,590,62,자기계발,오프라인강의,영상 교재,주1-2회,2,알고 있음,3
396,M,1992,3,380,297,677,381,306,687,382,345,727,40,자기계발,참고서,일반적인 영어 텍스트 기반 교재,주1-2회,1,알고 있음,6
397,F,1995,3,266,317,583,271,319,590,278,323,601,11,승진,참고서,뉴스/이슈 기반 교재,주3-4회,3,알고 있지 않음,4
398,M,2004,3,462,462,924,466,467,933,495,495,990,57,자기계발,온라인강의,영상 교재,매일(주 7회),10,알고 있음,14
399,F,2000,3,310,324,634,341,355,696,373,387,760,64,자기계발,참고서,뉴스/이슈 기반 교재,주3-4회,3,알고 있음,5
400,M,1989,3,261,310,571,311,320,631,363,372,735,104,자기계발,온라인강의,뉴스/이슈 기반 교재,주1-2회,2,알고 있음,6
401,F,1987,3,313,416,729,380,417,797,427,464,891,94,자기계발,온라인강의,뉴스/이슈 기반 교재,주3-4회,4,알고 있음,6
402,M,1984,3,369,345,714,399,375,774,448,424,872,98,자기계발,온라인강의,비즈니스 시뮬레이션(Role Play),주5-6회,6,알고 있음,8
403,F,1992,3,336,343,679,340,346,686,395,395,790,104,자기계발,온라인강의,영상 교재,주5-6회,5,알고 있음,8
404,M,1998,3,367,255,622,395,394,789,395,395,790,1,승진,온라인강의,영상 교재,주5-6회,5,알고 있음,11
405,F,1983,3,221,388,609,280,389,669,347,390,737,68,승진,오프라인강의,비즈니스 시뮬레이션(Role Play),매일(주 7회),9,알고 있음,11
406,M,1983,3,368,245,613,370,251,621,371,345,716,95,자기계발,온라인강의,뉴스/이슈 기반 교재,주3-4회,3,알고 있음,8
407,F,1995,3,315,234,549,318,239,557,319,312,631,74,승진,온라인강의,뉴스/이슈 기반 교재,매일(주 7회),8,알고 있음,14
408,M,1991,3,251,304,555,259,308,567,298,309,607,40,자기계발,참고서,일반적인 영어 텍스트 기반 교재,주1-2회,2,알고 있음,3
409,F,2001,3,172,143,315,190,187,377,231,221,452,75,자기계발,오프라인강의,영상 교재,매일(주 7회),7,알고 있음,16
410,M,1995,3,337,375,712,394,431,825,436,472,908,83,승진,온라인강의,영상 교재,주5-6회,6,알고 있음,10
411,F,1992,3,274,235,509,301,299,600,331,311,642,42,자기계발,오프라인강의,일반적인 영어 텍스트 기반 교재,매일(주 7회),8,알고 있음,13
412,M,2006,3,252,351,603,258,354,612,263,357,620,8,자기계발,온라인강의,일반적인 영어 텍스트 기반 교재,주1-2회,2,알고 있지 않음,3
413,F,1993,3,119,151,270,241,231,472,281,294,575,103,승진,온라인강의,영상 교재,매일(주 7회),9,알고 있음,19
414,M,1979,3,271,261,532,276,265,541,302,312,614,73,자기계발,온라인강의,뉴스/이슈 기반 교재,주1-2회,1,알고 있음,6
415,F,1995,3,368,374,742,417,423,840,464,470,934,94,자기계발,온라인강의,뉴스/이슈 기반 교재,주3-4회,4,알고 있음,7
416,M,1987,3,129,121,250,131,129,260,199,174,373,113,자기계발,오프라인강의,영상 교재,주5-6회,9,알고 있음,16
417,F,1993,3,414,405,819,416,412,828,458,454,912,84,자기계발,온라인강의,뉴스/이슈 기반 교재,주1-2회,2,알고 있음,3
418,M,1988,3,316,397,713,322,400,722,374,452,826,104,자기계발,온라인강의,뉴스/이슈 기반 교재,주5-6회,8,알고 있음,13
419,F,1992,3,445,398,843,446,437,883,487,479,966,83,승진,온라인강의,영상 교재,매일(주 7회),9,알고 있음,18
420,M,1990,3,487,458,945,488,466,954,495,495,990,36,자기계발,온라인강의,일반적인 영어 텍스트 기반 교재,주5-6회,6,알고 있음,12
421,F,1985,3,477,425,902,478,464,942,495,495,990,48,승진,오프라인강의,영상 교재,매일(주 7회),7,알고 있음,20
422,M,2001,3,440,467,907,490,491,981,495,495,990,9,자기계발,참고서,일반적인 영어 텍스트 기반 교재,주3-4회,4,알고 있음,5
423,F,1985,3,381,485,866,389,487,876,495,495,990,114,자기계발,오프라인강의,영상 교재,주5-6회,8,알고 있음,11
424,M,1981,3,480,404,884,493,489,982,495,495,990,8,승진,오프라인강의,비즈니스 시뮬레이션(Role Play),주1-2회,3,알고 있음,4
425,F,1987,3,256,204,460,259,211,470,260,258,518,48,승진,오프라인강의,비즈니스 시뮬레이션(Role Play),주1-2회,1,알고 있음,6
426,M,1991,3,334,447,781,446,448,894,478,480,958,64,승진,참고서,뉴스/이슈 기반 교재,주3-4회,4,알고 있음,7
427,F,1998,3,284,248,532,287,252,539,321,256,577,38,승진,오프라인강의,비즈니스 시뮬레이션(Role Play),매일(주 7회),10,알고 있음,17
428,M,1996,3,408,326,734,412,332,744,413,394,807,63,승진,오프라인강의,영상 교재,주1-2회,1,알고 있음,5
429,F,1993,3,370,466,836,472,467,939,495,495,990,51,자기계발,온라인강의,뉴스/이슈 기반 교재,매일(주 7회),7,알고 있음,20
430,M,1980,3,396,428,824,421,453,874,493,494,987,113,자기계발,오프라인강의,영상 교재,주5-6회,6,알고 있음,15
431,F,2005,3,342,458,800,350,459,809,423,460,883,74,자기계발,참고서,뉴스/이슈 기반 교재,매일(주 7회),10,알고 있음,16
432,M,1996,3,406,382,788,489,465,954,495,495,990,36,승진,온라인강의,영상 교재,주1-2회,1,알고 있음,5
433,F,2000,3,205,230,435,242,267,509,247,272,519,10,자기계발,참고서,일반적인 영어 텍스트 기반 교재,주1-2회,2,알고 있음,5
434,M,1997,3,456,471,927,493,494,987,495,495,990,3,승진,온라인강의,비즈니스 시뮬레이션(Role Play),주5-6회,5,알고 있음,17
435,F,1995,3,474,390,864,495,495,990,495,495,990,0,승진,참고서,일반적인 영어 텍스트 기반 교재,주1-2회,1,알고 있음,5
436,M,2001,3,352,330,682,357,334,691,361,339,700,9,자기계발,온라인강의,영상 교재,주5-6회,7,알고 있지 않음,12
437,F,2003,3,363,487,850,371,489,860,444,490,934,74,자기계발,오프라인강의,뉴스/이슈 기반 교재,매일(주 7회),10,알고 있음,5
438,M,1982,3,495,358,853,495,367,862,495,471,966,104,자기계발,참고서,뉴스/이슈 기반 교재,매일(주 7회),10,알고 있음,14
439,F,1985,3,327,439,766,346,440,786,443,441,884,98,자기계발,오프라인강의,비즈니스 시뮬레이션(Role Play),주5-6회,5,알고 있음,9
440,M,2007,3,428,329,757,430,337,767,431,399,830,63,자기계발,온라인강의,영상 교재,주1-2회,2,알고 있음,4
441,F,2000,3,420,407,827,461,448,909,493,480,973,64,자기계발,온라인강의,뉴스/이슈 기반 교재,주3-4회,4,알고 있음,8
442,M,1990,3,372,444,816,380,445,825,467,446,913,88,자기계발,오프라인강의,비즈니스 시뮬레이션(Role Play),주3-4회,3,알고 있음,7
443,F,1991,3,430,475,905,494,495,989,495,495,990,1,승진,온라인강의,비즈니스 시뮬레이션(Role Play),매일(주 7회),9,알고 있음,15
444,M,1997,3,246,224,470,251,231,482,271,261,532,50,승진,참고서,일반적인 영어 텍스트 기반 교재,주5-6회,8,알고 있음,9
445,F,1997,3,389,324,713,390,333,723,395,395,790,67,자기계발,온라인강의,영상 교재,주5-6회,6,알고 있음,12
446,M,1995,3,214,340,554,219,344,563,224,347,571,8,자기계발,온라인강의,뉴스/이슈 기반 교재,매일(주 7회),10,알고 있지 않음,14
447,F,1979,3,159,142,301,162,154,316,197,198,395,79,자기계발,온라인강의,일반적인 영어 텍스트 기반 교재,주1-2회,2,알고 있음,5
448,M,1985,3,280,271,551,301,300,601,321,328,649,48,승진,오프라인강의,영상 교재,주5-6회,7,알고 있음,12
449,F,1987,3,397,384,781,428,415,843,432,421,853,10,승진,참고서,일반적인 영어 텍스트 기반 교재,주1-2회,2,알고 있음,5
450,M,2006,3,373,311,684,376,319,695,377,328,705,10,자기계발,참고서,일반적인 영어 텍스트 기반 교재,주1-2회,4,알고 있음,1
451,F,1977,3,275,280,555,279,282,561,303,297,600,39,자기계발,온라인강의,일반적인 영어 텍스트 기반 교재,매일(주 7회),10,알고 있음,13
452,M,1980,3,301,265,566,338,302,640,339,341,680,40,자기계발,참고서,일반적인 영어 텍스트 기반 교재,주1-2회,2,알고 있음,3
453,F,1999,3,365,381,746,390,406,796,446,462,908,112,자기계발,온라인강의,영상 교재,주5-6회,6,알고 있음,12
454,M,1991,3,245,251,496,249,256,505,295,295,590,85,자기계발,온라인강의,영상 교재,주3-4회,3,알고 있음,6
455,F,2005,3,377,281,658,378,363,741,393,378,771,30,자기계발,참고서,일반적인 영어 텍스트 기반 교재,매일(주 7회),10,알고 있음,14
456,M,1996,3,281,280,561,320,293,613,330,328,658,45,승진,온라인강의,비즈니스 시뮬레이션(Role Play),주3-4회,3,알고 있음,5
457,F,2000,3,381,344,725,382,406,788,439,462,901,113,자기계발,온라인강의,영상 교재,매일(주 7회),10,알고 있음,18
458,M,1990,3,419,323,742,422,328,750,423,400,823,73,승진,온라인강의,영상 교재,주3-4회,4,알고 있음,8
459,F,1975,3,218,351,569,241,359,600,243,359,602,2,자기계발,오프라인강의,일반적인 영어 텍스트 기반 교재,주3-4회,5,알고 있음,10
460,M,1989,3,213,197,410,236,211,447,301,273,574,127,자기계발,온라인강의,영상 교재,매일(주 7회),9,알고 있음,16
461,F,1999,3,293,380,673,355,381,736,384,383,767,31,자기계발,참고서,일반적인 영어 텍스트 기반 교재,매일(주 7회),10,알고 있음,16
462,M,1979,3,278,338,616,301,339,640,326,364,690,50,자기계발,참고서,일반적인 영어 텍스트 기반 교재,주3-4회,5,알고 있음,12
463,F,2007,3,340,435,775,347,436,783,400,437,837,54,자기계발,온라인강의,뉴스/이슈 기반 교재,주1-2회,2,알고 있음,3
464,M,1990,3,370,334,704,373,339,712,425,391,816,104,자기계발,온라인강의,뉴스/이슈 기반 교재,매일(주 7회),9,알고 있음,18
465,F,2003,3,382,409,791,390,410,800,395,415,810,10,자기계발,참고서,일반적인 영어 텍스트 기반 교재,주1-2회,1,알고 있음,3
466,M,1999,3,371,279,650,372,288,660,383,382,765,105,자기계발,참고서,뉴스/이슈 기반 교재,매일(주 7회),10,알고 있음,14
467,F,2002,3,236,164,400,237,246,483,274,283,557,74,자기계발,참고서,뉴스/이슈 기반 교재,매일(주 7회),8,알고 있음,20
468,M,2000,3,316,345,661,323,348,671,355,379,734,63,자기계발,온라인강의,영상 교재,주1-2회,2,알고 있음,3
469,F,1985,3,322,312,634,374,364,738,383,375,758,20,승진,참고서,일반적인 영어 텍스트 기반 교재,주3-4회,3,알고 있음,7
470,M,2006,3,218,192,410,220,200,420,261,242,503,83,자기계발,오프라인강의,영상 교재,주5-6회,6,알고 있음,10
471,F,1999,3,220,247,467,227,250,477,242,265,507,30,승진,참고서,일반적인 영어 텍스트 기반 교재,주5-6회,6,알고 있음,8
472,M,2001,3,218,228,446,255,264,519,311,313,624,105,자기계발,온라인강의,뉴스/이슈 기반 교재,주1-2회,2,알고 있음,5
473,F,1990,3,294,325,619,301,335,636,309,339,648,12,자기계발,온라인강의,일반적인 영어 텍스트 기반 교재,주3-4회,3,알고 있음,9
474,M,1991,3,232,136,368,233,155,388,235,258,493,105,자기계발,오프라인강의,뉴스/이슈 기반 교재,매일(주 7회),8,알고 있음,12
475,F,1994,3,344,350,694,374,380,754,389,395,784,30,승진,참고서,일반적인 영어 텍스트 기반 교재,매일(주 7회),10,알고 있음,15
476,M,1984,3,283,343,626,289,346,635,296,349,645,10,자기계발,온라인강의,뉴스/이슈 기반 교재,주3-4회,3,알고 있지 않음,7
477,F,1986,3,291,245,536,310,295,605,395,373,768,163,자기계발,오프라인강의,비즈니스 시뮬레이션(Role Play),매일(주 7회),10,알고 있음,16
478,M,2000,3,337,335,672,367,365,732,396,394,790,58,승진,온라인강의,비즈니스 시뮬레이션(Role Play),주3-4회,3,알고 있음,7
479,F,1996,3,242,168,410,243,182,425,256,210,466,41,승진,온라인강의,비즈니스 시뮬레이션(Role Play),매일(주 7회),9,알고 있음,16
480,M,2004,3,219,286,505,251,301,552,308,294,602,50,자기계발,온라인강의,뉴스/이슈 기반 교재,주5-6회,5,알고 있음,17
481,F,1988,3,287,319,606,301,327,628,315,328,643,15,자기계발,온라인강의,비즈니스 시뮬레이션(Role Play),주3-4회,3,알고 있음,8
482,M,1987,3,275,329,604,294,337,631,355,355,710,79,자기계발,온라인강의,영상 교재,주1-2회,1,알고 있음,5
483,F,2003,3,453,327,780,454,400,854,474,453,927,73,자기계발,오프라인강의,영상 교재,주3-4회,5,알고 있음,7
484,M,1998,3,373,268,641,374,365,739,380,370,750,11,자기계발,참고서,일반적인 영어 텍스트 기반 교재,주5-6회,9,알고 있음,11
485,F,1992,3,328,451,779,411,452,863,484,482,966,103,자기계발,오프라인강의,영상 교재,주3-4회,4,알고 있음,6
486,M,1981,3,228,210,438,230,219,449,310,321,631,182,승진,참고서,일반적인 영어 텍스트 기반 교재,주3-4회,3,알고 있음,6
487,F,1974,3,371,371,742,375,376,751,431,432,863,112,자기계발,온라인강의,영상 교재,매일(주 7회),9,알고 있음,18
488,M,1989,3,234,206,440,237,212,449,252,227,479,30,승진,참고서,일반적인 영어 텍스트 기반 교재,주5-6회,5,알고 있음,10
489,F,1978,3,396,340,736,430,374,804,431,413,844,40,자기계발,오프라인강의,일반적인 영어 텍스트 기반 교재,주1-2회,2,알고 있음,3
490,M,1992,3,286,263,549,333,310,643,362,341,703,60,자기계발,참고서,일반적인 영어 텍스트 기반 교재,주5-6회,6,알고 있음,9
491,F,1985,3,269,331,600,271,338,609,287,330,617,8,승진,참고서,일반적인 영어 텍스트 기반 교재,매일(주 7회),9,알고 있음,17
492,M,1980,3,204,201,405,241,238,479,301,321,622,143,자기계발,오프라인강의,비즈니스 시뮬레이션(Role Play),매일(주 7회),10,알고 있음,16
493,F,2002,3,378,388,766,383,390,773,420,427,847,74,자기계발,참고서,뉴스/이슈 기반 교재,매일(주 7회),8,알고 있음,19
494,M,1996,3,276,251,527,299,301,600,301,310,611,11,승진,참고서,뉴스/이슈 기반 교재,주3-4회,3,알고 있음,6
495,F,2007,3,221,229,450,236,244,480,267,275,542,62,자기계발,온라인강의,영상 교재,주1-2회,0,알고 있음,5
496,M,2006,3,347,315,662,349,321,670,364,336,700,30,자기계발,온라인강의,일반적인 영어 텍스트 기반 교재,매일(주 7회),10,알고 있음,13
497,F,1988,3,112,250,362,120,251,371,187,252,439,68,승진,온라인강의,비즈니스 시뮬레이션(Role Play),매일(주 7회),9,알고 있음,17
498,M,2006,3,252,150,402,254,158,412,255,167,422,10,자기계발,오프라인강의,일반적인 영어 텍스트 기반 교재,주1-2회,0,알고 있음,4
499,F,1990,3,371,324,695,378,326,704,422,370,792,88,자기계발,오프라인강의,비즈니스 시뮬레이션(Role Play),주3-4회,4,알고 있음,7
500,M,1984,3,169,188,357,172,190,362,235,226,461,99,승진,오프라인강의,비즈니스 시뮬레이션(Role Play),주5-6회,7,알고 있음,15
